Institution Type / Institution,Fice Code,Average of Resident Tuition and Fees,Average of Non-Resident Tuition and Fees,Average of In-District Tuition and Fees,Average of Out-of-District Tuition and Fees,Average of Books and Supplies,Average of Room and Board off-Campus,Average of Transportation Off-Campus,Average of Personal Expenses Off-Campus,Average of Total Resident Costs,Average of Total Non Resident Costs,Average of Total In District Costs,Average of Total Out of District Costs,Year,Public / Private
Angelo State University,3541,5111,13541,0,0,1000,7516,1910,1910,17447,25877,12336,12336,2008,Public
Lamar University,3581,6014,14444,0,0,1410,7092,2208,2076,18800,27230,12786,12786,2008,Public
Midwestern State University,3592,6237,14667,0,0,1200,6121,1285,1379,16222,24652,9985,9985,2008,Public
Prairie View A&M University,3630,6118,14458,0,0,1000,8500,1500,1500,18618,26958,12500,12500,2008,Public
Sam Houston State University,3606,5910,14250,0,0,1038,7496,3304,1724,19472,27812,13562,13562,2008,Public
Stephen F. Austin State University,3624,6432,14862,0,0,1020,7022,2581,1593,18648,27078,12216,12216,2008,Public
Sul Ross State University,3625,5058,13398,0,0,1137,6150,1720,1916,15981,24321,10923,10923,2008,Public
Sul Ross State University Rio Grande College,20,3456,11886,0,0,555,0,0,0,4011,12441,555,555,2008,Public
Tarleton State University,3631,5590,14020,0,0,1118,7252,1058,2162,17180,25610,11590,11590,2008,Public
Texas A&M International University,9651,5417,13757,0,0,1300,6750,1026,2205,16698,25038,11281,11281,2008,Public
Texas A&M University,3632,7899,22330,0,0,1200,8000,664,2187,19950,34381,12051,12051,2008,Public
Texas A&M University at Galveston,10298,6511,15148,0,0,1200,8000,693,2215,18619,27256,12108,12108,2008,Public
Texas A&M University-Commerce,3565,5130,13380,0,0,1300,7260,1400,1740,16830,25080,11700,11700,2008,Public
Texas A&M University-Corpus Christi,11161,5737,14167,0,0,1151,6782,1534,1367,16571,25001,10834,10834,2008,Public
Texas A&M University-Kingsville,3639,5424,13854,0,0,1150,6436,2188,2510,17708,26138,12284,12284,2008,Public
Texas A&M University-Texarkana,29269,4236,12666,0,0,1160,5124,2328,1648,14496,22926,10260,10260,2008,Public
Texas Southern University,3642,5878,14128,0,0,1279,7163,1696,2158,18174,26424,12296,12296,2008,Public
Texas State University,3615,6990,15420,0,0,1000,7160,1260,2000,18410,26840,11420,11420,2008,Public
Texas Tech University,3644,7083,15423,0,0,845,7210,1436,1890,18464,26804,11381,11381,2008,Public
Texas Woman's University,3646,6540,10140,0,0,960,5832,1132,2162,16626,20226,10086,10086,2008,Public
The University of Texas at Arlington,3656,8142,14778,0,0,882,6646,2400,1450,19520,26156,11378,11378,2008,Public
The University of Texas at Austin,3658,8508,19136,0,0,818,9500,962,2354,22142,32770,13634,13634,2008,Public
The University of Texas at Brownsville,30646,5258,13688,0,0,615,8587,1608,2482,18550,26980,13292,13292,2008,Public
The University of Texas at Dallas,9741,9850,21000,0,0,1200,6828,2241,1929,22048,33198,12198,12198,2008,Public
The University of Texas at El Paso,3661,5926,14356,0,0,1152,9954,1822,1494,20348,28778,14422,14422,2008,Public
The University of Texas at San Antonio,10115,7666,16096,0,0,1000,8322,2358,1750,21096,29526,13430,13430,2008,Public
The University of Texas at Tyler,11163,5742,14172,0,0,920,7682,1820,1174,17338,25768,11596,11596,2008,Public
The University of Texas Permian Basin,9930,4800,12870,0,0,900,4600,1601,1905,13806,21876,9006,9006,2008,Public
The University of Texas-Rio Grande Valley,3599,5125,13465,0,0,1000,6984,2732,1800,17641,25981,12516,12516,2008,Public
University of Houston,3652,8168,16598,0,0,1100,9233,2497,2624,23622,32052,15454,15454,2008,Public
University of Houston-Clear Lake,11711,5532,14442,0,0,976,10308,1200,3160,21176,30086,15644,15644,2008,Public
University of Houston-Downtown,12826,4934,13274,0,0,1076,8600,3200,3800,21610,29950,16676,16676,2008,Public
University of Houston-Victoria,13231,5220,13650,0,0,1050,7596,1922,2028,17816,26246,12596,12596,2008,Public
University of North Texas,3594,7120,15550,0,0,1210,6340,1960,1840,18470,26900,11350,11350,2008,Public
West Texas A&M University,3665,5340,13680,0,0,1000,5506,1440,1900,15186,23526,9846,9846,2008,Public
Abilene Christian University,3537,18930,18400,0,0,1150,4086,1390,1794,27350,26820,8420,8420,2008,Private
Austin College,3543,26555,26555,0,0,1000,3750,250,750,32305,32305,5750,5750,2008,Private
Baylor University,3545,26234,26534,0,0,1634,7608,2252,2416,40144,40444,13910,13910,2008,Private
Concordia University Texas,3557,20490,20490,0,0,1200,4938,735,1195,28558,28558,8068,8068,2008,Private
Dallas Baptist University,3560,16440,16440,0,0,1800,8217,2349,1602,30408,30408,13968,13968,2008,Private
East Texas Baptist University,3564,16140,16140,0,0,866,4416,807,1405,23634,23634,7494,7494,2008,Private
Hardin-Simmons University,3571,18380,18380,0,0,800,5180,1100,1482,26942,26942,8562,8562,2008,Private
Houston Baptist University,3576,19390,19390,0,0,1230,6765,1773,1825,30983,30983,11593,11593,2008,Private
Howard Payne University,3575,17400,17400,0,0,1200,3834,1060,1600,25094,25094,7694,7694,2008,Private
Huston-Tillotson University,3577,10258,10258,0,0,0,7308,1369,2326,21261,21261,11003,11003,2008,Private
Jarvis Christian College,3637,8373,8373,0,0,800,5708,1000,1750,17631,17631,9258,9258,2008,Private
Letourneau University,3584,19640,19640,0,0,1300,11800,1150,1520,35410,35410,15770,15770,2008,Private
Lubbock Christian University,3586,14700,14700,0,0,1100,5884,1836,2054,25574,25574,10874,10874,2008,Private
McMurry University,3591,18135,18135,0,0,1200,5000,1800,1800,27935,27935,9800,9800,2008,Private
Our Lady of the Lake University of San Antonio,3598,20232,20232,0,0,1200,3000,1450,1850,27732,27732,7500,7500,2008,Private
Paul Quinn College,3602,9780,9780,0,0,1200,5170,1100,1000,18250,18250,8470,8470,2008,Private
Rice University,3604,30486,30486,0,0,800,10750,600,1550,44186,44186,13700,13700,2008,Private
Schreiner University,3610,17992,17992,0,0,1000,6810,1000,1000,27802,27802,9810,9810,2008,Private
Southern Methodist University,3613,33170,33170,0,0,800,7500,1000,1100,43570,43570,10400,10400,2008,Private
Southwestern Adventist University,3619,15236,15236,0,0,936,4214,1304,1254,22944,22944,7708,7708,2008,Private
Southwestern Assemblies of God University,3616,12850,12850,0,0,1146,12094,3574,2354,32018,32018,19168,19168,2008,Private
Southwestern Christian College,3618,6182,6182,0,0,630,3308,800,400,11320,11320,5138,5138,2008,Private
Southwestern University,3620,27940,27940,0,0,1000,4940,430,950,35260,35260,7320,7320,2008,Private
St. Edward's University,3621,22770,22770,0,0,1100,7150,870,2110,34000,34000,11230,11230,2008,Private
St. Mary's University,3623,21156,21156,0,0,2200,4000,800,1844,30000,30000,8844,8844,2008,Private
Texas Christian University,3636,26948,26948,0,0,880,9600,800,1500,39728,39728,12780,12780,2008,Private
Texas College,3638,9228,9228,0,0,800,6380,650,1740,18798,18798,9570,9570,2008,Private
Texas Lutheran University,3641,20970,20970,0,0,950,5430,1500,960,29810,29810,8840,8840,2008,Private
Texas Wesleyan University,3645,16730,16730,0,0,1020,6174,999,1863,26786,26786,10056,10056,2008,Private
The College of Saints John Fisher & Thomas More,420352,12250,12250,0,0,650,45000,1700,1675,61275,61275,49025,49025,2008,Private
Trinity University,3647,26834,26834,0,0,950,5918,0,1050,34752,34752,7918,7918,2008,Private
University of Dallas,3651,24770,24770,0,0,1700,7603,1200,1500,36773,36773,12003,12003,2008,Private
University of Mary Hardin-Baylor,3588,19650,19650,0,0,1200,5810,1638,1702,30000,30000,10350,10350,2008,Private
University of St. Thomas,3654,20560,20560,0,0,1030,9206,2533,1888,35217,35217,14657,14657,2008,Private
University of the Incarnate Word,3578,20260,20260,0,0,1000,5408,1152,1560,29380,29380,9120,9120,2008,Private
Wayland Baptist University,3663,12100,12100,0,0,1248,7488,973,1732,23541,23541,11441,11441,2008,Private
Wiley College,3669,9970,9970,0,0,286,4540,2270,1334,18400,18400,8430,8430,2008,Private
Angelo State University,3541,5410,13840,0,0,1150,7918,1968,1968,18414,26844,13004,13004,2009,Public
Lamar University,3581,6606,14916,0,0,1480,7448,2320,2180,20034,28344,13428,13428,2009,Public
Midwestern State University,3592,6544,14854,0,0,1500,6488,1362,1462,17356,25666,10812,10812,2009,Public
Prairie View A&M University,3630,6664,14974,0,0,1138,7618,1000,1000,17420,25730,10756,10756,2009,Public
Sam Houston State University,3606,6515,14825,0,0,1063,7764,3380,1764,20486,28796,13971,13971,2009,Public
Stephen F. Austin State University,3624,6528,14838,0,0,1072,7377,2711,1673,19361,27671,12833,12833,2009,Public
Sul Ross State University,3625,5302,13732,0,0,1195,6460,1806,2012,16775,25205,11473,11473,2009,Public
Sul Ross State University Rio Grande College,20,3636,11946,0,0,569,0,0,0,4205,12515,569,569,2009,Public
Tarleton State University,3631,5942,14372,0,0,1174,7680,1111,2270,18177,26607,12235,12235,2009,Public
Texas A&M International University,9651,5746,14176,0,0,1750,6918,1052,2260,17726,26156,11980,11980,2009,Public
Texas A&M University,3632,8391,22701,0,0,1278,8039,600,2223,20531,34841,12140,12140,2009,Public
Texas A&M University at Galveston,10298,7063,15493,0,0,1278,8039,1200,2223,19803,28233,12740,12740,2009,Public
Texas A&M University-Commerce,3565,5500,13840,0,0,1400,7822,1500,1830,18052,26392,12552,12552,2009,Public
Texas A&M University-Corpus Christi,11161,6098,14408,0,0,1208,8941,1611,1436,19294,27604,13196,13196,2009,Public
Texas A&M University-Kingsville,3639,5694,14544,0,0,1200,6762,2298,2636,18590,27440,12896,12896,2009,Public
Texas A&M University-Texarkana,29269,4538,12848,0,0,1160,5380,2616,1728,15422,23732,10884,10884,2009,Public
Texas Southern University,3642,6401,14711,0,0,1343,12380,2128,2266,24518,32828,18117,18117,2009,Public
Texas State University,3615,7480,15790,0,0,1050,7520,1310,2100,19460,27770,11980,11980,2009,Public
Texas Tech University,3644,7785,16095,0,0,1000,7688,1500,1890,19863,28173,12078,12078,2009,Public
Texas Woman's University,3646,6660,14970,0,0,990,5932,1154,2204,16940,25250,10280,10280,2009,Public
The University of Texas at Arlington,3656,8378,15684,0,0,908,7362,2500,1490,20638,27944,12260,12260,2009,Public
The University of Texas at Austin,3658,8842,20416,0,0,860,9980,1010,2472,23164,34738,14322,14322,2009,Public
The University of Texas at Brownsville,30646,5498,13808,0,0,646,9021,1689,2608,19462,27772,13964,13964,2009,Public
The University of Texas at Dallas,9741,10340,23730,0,0,1200,7200,2000,1929,22669,36059,12329,12329,2009,Public
The University of Texas at El Paso,3661,6224,14534,0,0,1299,10504,1914,1570,21511,29821,15287,15287,2009,Public
The University of Texas at San Antonio,10115,8092,16402,0,0,1000,8322,2358,1750,21522,29832,13430,13430,2009,Public
The University of Texas at Tyler,11163,6042,14472,0,0,950,8070,1912,1233,18207,26637,12165,12165,2009,Public
The University of Texas Permian Basin,9930,5300,13730,0,0,910,4645,1617,1922,14394,22824,9094,9094,2009,Public
The University of Texas-Rio Grande Valley,3599,5425,13735,0,0,1000,6984,2732,1800,17941,26251,12516,12516,2009,Public
University of Houston,3652,8496,16598,0,0,1100,9233,2497,2624,23950,32052,15454,15454,2009,Public
University of Houston-Clear Lake,11711,5798,15038,0,0,1024,10828,1260,3318,22228,31468,16430,16430,2009,Public
University of Houston-Downtown,12826,5000,13430,0,0,1076,8600,3200,3800,21676,30106,16676,16676,2009,Public
University of Houston-Victoria,13231,5400,13710,0,0,1100,8776,1922,2028,19226,27536,13826,13826,2009,Public
University of North Texas,3594,7660,15970,0,0,1250,6530,2064,1896,19400,27710,11740,11740,2009,Public
West Texas A&M University,3665,5890,14200,0,0,1000,5898,1850,1900,16538,24848,10648,10648,2009,Public
Abilene Christian University,3537,20290,20290,0,0,1200,4250,1440,1860,29040,29040,8750,8750,2009,Private
Austin College,3543,27875,27875,0,0,1200,3750,500,800,34125,34125,6250,6250,2009,Private
Baylor University,3545,27910,27910,0,0,1398,6876,2250,2206,40640,40640,12730,12730,2009,Private
Concordia University Texas,3557,21200,21200,0,0,1300,5187,770,1255,29712,29712,8512,8512,2009,Private
Dallas Baptist University,3560,17490,17490,0,0,1950,8631,2466,1683,32220,32220,14730,14730,2009,Private
East Texas Baptist University,3564,17180,17180,0,0,892,4586,848,1448,24954,24954,7774,7774,2009,Private
Hardin-Simmons University,3571,19790,19790,0,0,800,5788,1098,1476,28952,28952,9162,9162,2009,Private
Houston Baptist University,3576,20830,20830,0,0,1230,7100,2220,1825,33205,33205,12375,12375,2009,Private
Howard Payne University,3575,18650,18650,0,0,1200,3940,1090,1620,26500,26500,7850,7850,2009,Private
Huston-Tillotson University,3577,10634,10634,0,0,800,7190,1326,2252,22202,22202,11568,11568,2009,Private
Jarvis Christian College,3637,9608,9608,0,0,1000,5996,1200,1800,19604,19604,9996,9996,2009,Private
Letourneau University,3584,20900,20900,0,0,1365,9015,1200,1595,34075,34075,13175,13175,2009,Private
Lubbock Christian University,3586,15280,15280,0,0,1150,6182,1928,2158,26698,26698,11418,11418,2009,Private
McMurry University,3591,19430,19430,0,0,1200,5074,1827,1827,29358,29358,9928,9928,2009,Private
Our Lady of the Lake University of San Antonio,3598,20824,20824,0,0,1200,6538,1450,1850,31862,31862,11038,11038,2009,Private
Paul Quinn College,3602,10850,10850,0,0,800,6350,1400,1400,20800,20800,9950,9950,2009,Private
Rice University,3604,32057,32057,0,0,800,11230,600,1550,46237,46237,14180,14180,2009,Private
Schreiner University,3610,18731,18731,0,0,1000,6810,1000,1000,28541,28541,9810,9810,2009,Private
Southern Methodist University,3613,35160,35160,0,0,800,7500,1000,1100,45560,45560,10400,10400,2009,Private
Southwestern Adventist University,3619,15836,15836,0,0,1008,6674,1386,1268,26172,26172,10336,10336,2009,Private
Southwestern Assemblies of God University,3616,13780,13780,0,0,1204,12706,1878,2474,32042,32042,18262,18262,2009,Private
Southwestern Christian College,3618,6182,6182,0,0,630,3308,800,400,11320,11320,5138,5138,2009,Private
Southwestern University,3620,30220,30220,0,0,1000,5070,450,950,37690,37690,7470,7470,2009,Private
St. Edward's University,3621,24440,24440,0,0,1100,8400,870,1790,36600,36600,12160,12160,2009,Private
St. Mary's University,3623,21876,21876,0,0,1300,4000,800,2024,30000,30000,8124,8124,2009,Private
Texas Christian University,3636,28298,28298,0,0,1000,9780,800,1500,41378,41378,13080,13080,2009,Private
Texas College,3638,9228,9228,0,0,800,6380,650,1740,18798,18798,9570,9570,2009,Private
Texas Lutheran University,3641,21910,21910,0,0,950,5430,1500,960,30750,30750,8840,8840,2009,Private
Texas Wesleyan University,3645,17760,17760,0,0,1020,6390,999,1935,28104,28104,10344,10344,2009,Private
The College of Saints John Fisher & Thomas More,420352,12490,12490,0,0,650,4750,1750,1725,21365,21365,8875,8875,2009,Private
Trinity University,3647,28452,28452,0,0,950,6160,0,1050,36612,36612,8160,8160,2009,Private
University of Dallas,3651,26293,26293,0,0,1700,8150,1800,1500,39443,39443,13150,13150,2009,Private
University of Mary Hardin-Baylor,3588,20550,20550,0,0,1200,5810,1738,1702,31000,31000,10450,10450,2009,Private
University of St. Thomas,3654,21880,21880,0,0,530,9482,2532,1944,36368,36368,14488,14488,2009,Private
University of the Incarnate Word,3578,21290,21290,0,0,1200,5514,1174,1590,30768,30768,9478,9478,2009,Private
Wayland Baptist University,3663,12966,12966,0,0,1248,7862,1010,1820,24906,24906,11940,11940,2009,Private
Wiley College,3669,9970,9970,0,0,200,4760,1200,1060,17190,17190,7220,7220,2009,Private
Angelo State University,3541,6140,14450,0,0,1150,8338,2025,2025,19678,27988,13538,13538,2010,Public
Lamar University,3581,6924,16224,0,0,1452,7304,2276,2138,20094,29394,13170,13170,2010,Public
Midwestern State University,3592,7038,16338,0,0,1500,6682,1402,1506,18128,27428,11090,11090,2010,Public
Prairie View A&M University,3630,6664,14974,0,0,1000,6738,1000,1000,16402,24712,9738,9738,2010,Public
Sam Houston State University,3606,7000,16300,0,0,1084,8016,3316,1730,21146,30446,14146,14146,2010,Public
Stephen F. Austin State University,3624,6998,16297,0,0,1094,7670,2766,1708,20236,29535,13238,13238,2010,Public
Sul Ross State University,3625,5516,14816,0,0,1194,6600,1806,2012,17128,26428,11612,11612,2010,Public
Sul Ross State University Rio Grande College,20,3786,13086,0,0,597,0,0,0,4383,13683,597,597,2010,Public
Tarleton State University,3631,5942,14372,0,0,1174,8542,1111,2270,19039,27469,13097,13097,2010,Public
Texas A&M International University,9651,6093,15393,0,0,1750,6918,1052,2260,18073,27373,11980,11980,2010,Public
Texas A&M University,3632,8481,23781,0,0,1350,8008,550,2225,20614,35914,12133,12133,2010,Public
Texas A&M University at Galveston,10298,7262,17112,0,0,1350,8008,550,2225,19395,29245,12133,12133,2010,Public
Texas A&M University-Central Texas,42295,5942,14372,0,0,1174,8542,1111,2270,19039,27469,13097,13097,2010,Public
Texas A&M University-Commerce,3565,5998,15298,0,0,1400,7978,1545,1867,18788,28088,12790,12790,2010,Public
Texas A&M University-Corpus Christi,11161,6399,15699,0,0,1185,9175,1580,1408,19747,29047,13348,13348,2010,Public
Texas A&M University-Kingsville,3639,6316,15616,0,0,1300,6762,2298,2636,19312,28612,12996,12996,2010,Public
Texas A&M University-San Antonio,42485,5620,13930,0,0,1300,7066,2298,2636,18920,27230,13300,13300,2010,Public
Texas A&M University-Texarkana,29269,4866,14166,0,0,1338,5380,2616,1728,15928,25228,11062,11062,2010,Public
Texas Southern University,3642,7361,15451,0,0,1342,12380,2128,2266,25477,33567,18116,18116,2010,Public
Texas State University,3615,7830,17130,0,0,1050,7520,1310,2100,19810,29110,11980,11980,2010,Public
Texas Tech University,3644,8560,17860,0,0,1000,7966,1500,1890,20916,30216,12356,12356,2010,Public
Texas Woman's University,3646,6960,16260,0,0,1020,6050,1176,2248,17454,26754,10494,10494,2010,Public
The University of Texas at Arlington,3656,8690,15996,0,0,908,7472,2538,1512,21120,28426,12430,12430,2010,Public
The University of Texas at Austin,3658,9418,21352,0,0,874,10250,1200,2424,24166,36100,14748,14748,2010,Public
The University of Texas at Brownsville,30646,5714,15014,0,0,646,9021,1689,2608,19678,28978,13964,13964,2010,Public
The University of Texas at Dallas,9741,10744,25866,0,0,1200,8310,2000,1930,24184,39306,13440,13440,2010,Public
The University of Texas at El Paso,3661,6504,15804,0,0,1335,10814,1972,1616,22241,31541,15737,15737,2010,Public
The University of Texas at San Antonio,10115,8410,16720,0,0,1000,8482,2358,1785,22035,30345,13625,13625,2010,Public
The University of Texas at Tyler,11163,6322,15622,0,0,1100,9214,1874,1209,19719,29019,13397,13397,2010,Public
The University of Texas Permian Basin,9930,6229,14539,0,0,915,4661,1619,1924,15348,23658,9119,9119,2010,Public
The University of Texas-Rio Grande Valley,3599,5699,14999,0,0,1000,7565,2803,1847,18914,28214,13215,13215,2010,Public
University of Houston,3652,8897,16598,0,0,1100,9233,2497,2624,24351,32052,15454,15454,2010,Public
University of Houston-Clear Lake,11711,6188,16508,0,0,1024,10618,1236,3254,22320,32640,16132,16132,2010,Public
University of Houston-Downtown,12826,5492,14792,0,0,1100,8600,3200,3800,22192,31492,16700,16700,2010,Public
University of Houston-Victoria,13231,5604,14904,0,0,1188,8344,2025,2028,19189,28489,13585,13585,2010,Public
University of North Texas,3594,7960,17260,0,0,1050,6530,2064,1896,19500,28800,11540,11540,2010,Public
University of North Texas at Dallas,42421,6450,15750,0,0,1050,6530,2064,1896,17990,27290,11540,11540,2010,Public
West Texas A&M University,3665,6207,15507,0,0,1000,6134,2000,2000,17341,26641,11134,11134,2010,Public
Abilene Christian University,3537,22760,22760,0,0,1250,7884,1490,1916,35300,35300,12540,12540,2010,Private
Amberton University,22594,7000,7000,0,0,1250,0,0,0,8250,8250,1250,1250,2010,Private
Austin College,3543,29260,29260,0,0,1200,3750,500,800,35510,35510,6250,6250,2010,Private
Baylor University,3545,29724,29724,0,0,1140,6876,2250,2206,42196,42196,12472,12472,2010,Private
Concordia University Texas,3557,21700,21700,0,0,1375,5450,810,1320,30655,30655,8955,8955,2010,Private
Dallas Baptist University,3560,18690,18690,0,0,2040,9063,2592,1764,34149,34149,15459,15459,2010,Private
East Texas Baptist University,3564,19550,19550,0,0,892,4586,848,1448,27324,27324,7774,7774,2010,Private
Hardin-Simmons University,3571,20990,20990,0,0,800,6282,1098,1476,30646,30646,9656,9656,2010,Private
Houston Baptist University,3576,23180,23180,0,0,1350,7100,2310,1900,35840,35840,12660,12660,2010,Private
Howard Payne University,3575,19950,19950,0,0,1200,3940,1090,1620,27800,27800,7850,7850,2010,Private
Huston-Tillotson University,3577,11630,11630,0,0,1400,7446,1326,2252,24054,24054,12424,12424,2010,Private
Jarvis Christian College,3637,11146,11146,0,0,1300,7788,1200,1800,23234,23234,12088,12088,2010,Private
Letourneau University,3584,22510,22510,0,0,1390,9000,1220,1630,35750,35750,13240,13240,2010,Private
Lubbock Christian University,3586,16180,16180,0,0,1150,6368,1928,2158,27784,27784,11604,11604,2010,Private
McMurry University,3591,20830,20830,0,0,1200,5228,1888,1888,31034,31034,10204,10204,2010,Private
Our Lady of the Lake University of San Antonio,3598,21900,21900,0,0,1200,6838,1450,1850,33238,33238,11338,11338,2010,Private
Paul Quinn College,3602,12100,12100,0,0,600,6200,1400,2400,22700,22700,10600,10600,2010,Private
Rice University,3604,33771,33771,0,0,800,11750,600,1550,48471,48471,14700,14700,2010,Private
Schreiner University,3610,19547,19547,0,0,1200,6810,1000,1000,29557,29557,10010,10010,2010,Private
Southern Methodist University,3613,37230,37230,0,0,800,7500,1000,1600,48130,48130,10900,10900,2010,Private
Southwestern Adventist University,3619,16456,16456,0,0,1086,6748,1280,1290,26860,26860,10404,10404,2010,Private
Southwestern Assemblies of God University,3616,14830,14830,0,0,1228,12960,1916,2524,33458,33458,18628,18628,2010,Private
Southwestern Christian College,3618,6182,6182,0,0,900,3411,800,600,11893,11893,5711,5711,2010,Private
Southwestern University,3620,31630,31630,0,0,1000,5320,450,950,39350,39350,7720,7720,2010,Private
St. Edward's University,3621,26484,26484,0,0,1100,8400,826,1790,38600,38600,12116,12116,2010,Private
St. Mary's University,3623,22576,22576,0,0,1300,4000,800,2004,30680,30680,8104,8104,2010,Private
Texas Christian University,3636,30048,30048,0,0,1000,10000,900,1500,43448,43448,13400,13400,2010,Private
Texas College,3638,9490,9490,0,0,800,6380,650,1740,19060,19060,9570,9570,2010,Private
Texas Lutheran University,3641,22890,22890,0,0,950,5430,1500,960,31730,31730,8840,8840,2010,Private
Texas Wesleyan University,3645,18710,18710,0,0,1052,6750,1035,2088,29635,29635,10925,10925,2010,Private
The College of Saints John Fisher & Thomas More,420352,12800,12800,0,0,650,4892,1802,1801,21945,21945,9145,9145,2010,Private
Trinity University,3647,30012,30012,0,0,950,6386,0,1050,38398,38398,8386,8386,2010,Private
University of Dallas,3651,27815,27815,0,0,1700,8200,1800,1800,41315,41315,13500,13500,2010,Private
University of Mary Hardin-Baylor,3588,21600,21600,0,0,1200,6040,1848,1812,32500,32500,10900,10900,2010,Private
University of St. Thomas,3654,23500,23500,0,0,1030,9482,2533,1944,38489,38489,14989,14989,2010,Private
University of the Incarnate Word,3578,21890,21890,0,0,1200,5622,1196,1620,31528,31528,9638,9638,2010,Private
Wayland Baptist University,3663,13590,13590,0,0,1300,7900,1070,1900,25760,25760,12170,12170,2010,Private
Wiley College,3669,11050,11050,0,0,800,6136,1000,600,19586,19586,8536,8536,2010,Private
Angelo State University,3541,7155,17106,0,0,1500,7433,2450,1750,20288,30239,13133,13133,2011,Public
Lamar University,3581,7630,17020,0,0,1468,7392,2304,2164,20958,30348,13328,13328,2011,Public
Midwestern State University,3592,7304,8204,0,0,1500,6816,1800,1536,18956,19856,11652,11652,2011,Public
Prairie View A&M University,3630,6664,14974,0,0,1200,6738,1000,1000,16602,24912,9938,9938,2011,Public
Sam Houston State University,3606,7328,16718,0,0,1096,8446,3356,1750,21976,31366,14648,14648,2011,Public
Stephen F. Austin State University,3624,7344,16734,0,0,1107,8186,2800,1729,21166,30556,13822,13822,2011,Public
Sul Ross State University,3625,5760,15060,0,0,1208,6426,2378,1500,17272,26572,11512,11512,2011,Public
Sul Ross State University Rio Grande College,20,3966,0,0,0,0,0,0,0,3966,0,0,0,2011,Public
Tarleton State University,3631,6248,15638,0,0,1174,8858,1111,2270,19661,29051,13413,13413,2011,Public
Texas A&M International University,9651,6558,15858,0,0,1750,6918,1074,2288,18588,27888,12030,12030,2011,Public
Texas A&M University,3632,8480,23870,0,0,1340,8200,500,2262,20782,36172,12302,12302,2011,Public
Texas A&M University at Galveston,10298,7578,17378,0,0,1340,8200,500,2262,19880,29680,12302,12302,2011,Public
Texas A&M University-Central Texas,42295,6248,15638,0,0,1174,8858,1111,2270,19661,29051,13413,13413,2011,Public
Texas A&M University-Commerce,3565,6283,15673,0,0,1400,8106,2070,1867,19726,29116,13443,13443,2011,Public
Texas A&M University-Corpus Christi,11161,7083,16473,0,0,1199,9219,1599,1425,20525,29915,13442,13442,2011,Public
Texas A&M University-Kingsville,3639,6640,15930,0,0,1300,6844,2326,2668,19778,29068,13138,13138,2011,Public
Texas A&M University-San Antonio,42485,6143,14453,0,0,1300,7151,2326,2668,19588,27898,13445,13445,2011,Public
Texas A&M University-Texarkana,29269,4946,14246,0,0,1354,8100,2648,1749,18797,28097,13851,13851,2011,Public
Texas Southern University,3642,7462,16762,0,0,1400,12530,2154,2293,25839,35139,18377,18377,2011,Public
Texas State University,3615,8230,17620,0,0,1060,7520,1320,2120,20250,29640,12020,12020,2011,Public
Texas Tech University,3644,9064,18454,0,0,1200,8283,2000,1890,22437,31827,13373,13373,2011,Public
Texas Woman's University,3646,6960,16260,0,0,1020,6170,1176,2248,17574,26874,10614,10614,2011,Public
The University of Texas at Arlington,3656,9152,16458,0,0,908,7554,2566,1528,21708,29014,12556,12556,2011,Public
The University of Texas at Austin,3658,9794,32506,0,0,874,10422,1200,2424,24714,47426,14920,14920,2011,Public
The University of Texas at Brownsville,30646,5994,15384,0,0,1214,10931,1822,1822,21783,31173,15789,15789,2011,Public
The University of Texas at Dallas,9741,11168,28194,0,0,1200,8788,2000,1930,25086,42112,13918,13918,2011,Public
The University of Texas at El Paso,3661,6869,16258,0,0,1384,11140,2030,1664,23087,32476,16218,16218,2011,Public
The University of Texas at San Antonio,10115,8790,18180,0,0,1000,8487,2660,1800,22737,32127,13947,13947,2011,Public
The University of Texas at Tyler,11163,6592,15982,0,0,1301,9692,1896,1224,20705,30095,14113,14113,2011,Public
The University of Texas Permian Basin,9930,6508,15898,0,0,915,4661,1639,1924,15647,25037,9139,9139,2011,Public
The University of Texas-Rio Grande Valley,3599,5978,15368,0,0,1000,7565,2837,1869,19249,28639,13271,13271,2011,Public
University of Houston,3652,9211,18059,0,0,1200,9800,2498,2624,25333,34181,16122,16122,2011,Public
University of Houston-Clear Lake,11711,6508,17346,0,0,1050,8458,3238,3736,22990,33828,16482,16482,2011,Public
University of Houston-Downtown,12826,5716,14792,0,0,1100,8600,3200,6198,24814,33890,19098,19098,2011,Public
University of Houston-Victoria,13231,5830,15220,0,0,1200,8344,2070,2054,19498,28888,13668,13668,2011,Public
University of North Texas,3594,8736,18126,0,0,1050,6586,2150,1948,20470,29860,11734,11734,2011,Public
University of North Texas at Dallas,42421,6600,15900,0,0,1050,6358,2150,1948,18106,27406,11506,11506,2011,Public
West Texas A&M University,3665,6207,15507,0,0,1000,6600,2000,2000,17807,27107,11600,11600,2011,Public
Abilene Christian University,3537,25270,25270,0,0,1250,8316,1500,1914,38250,38250,12980,12980,2011,Private
Amberton University,22594,7050,7050,0,0,0,0,0,0,7050,7050,0,0,2011,Private
Austin College,3543,31295,31295,0,0,1200,3810,500,800,37605,37605,6310,6310,2011,Private
Baylor University,3545,31658,31658,0,0,1390,7352,2094,2118,44612,44612,12954,12954,2011,Private
Concordia University Texas,3557,22920,22920,0,0,1440,5720,850,1380,32310,32310,9390,9390,2011,Private
Dallas Baptist University,3560,19800,19800,0,0,2130,9423,2745,1836,35934,35934,16134,16134,2011,Private
East Texas Baptist University,3564,20500,20500,0,0,892,4586,864,1448,28290,28290,7790,7790,2011,Private
Hardin-Simmons University,3571,22460,22460,0,0,800,6804,1098,1476,32638,32638,10178,10178,2011,Private
Houston Baptist University,3576,25395,25395,0,0,0,7380,2400,1980,37155,37155,11760,11760,2011,Private
Howard Payne University,3575,21700,21700,0,0,1200,3980,1100,1620,29600,29600,7900,7900,2011,Private
Huston-Tillotson University,3577,11630,11630,0,0,0,7446,2126,2782,23984,23984,12354,12354,2011,Private
Jarvis Christian College,3637,13375,13375,0,0,1300,9346,1200,1800,27021,27021,13646,13646,2011,Private
Letourneau University,3584,24120,24120,0,0,1420,9450,1240,1630,37860,37860,13740,13740,2011,Private
Lubbock Christian University,3586,16870,16870,0,0,1150,6446,1952,2184,28602,28602,11732,11732,2011,Private
McMurry University,3591,22045,22045,0,0,1200,5292,1911,1911,32359,32359,10314,10314,2011,Private
Our Lady of the Lake University of San Antonio,3598,22756,22756,0,0,1200,7088,1450,1850,34344,34344,11588,11588,2011,Private
Paul Quinn College,3602,12600,12600,0,0,800,7100,1400,2400,24300,24300,11700,11700,2011,Private
Rice University,3604,35551,35551,0,0,800,12270,600,1550,50771,50771,15220,15220,2011,Private
Schreiner University,3610,20355,20355,0,0,0,6810,1000,1000,29165,29165,8810,8810,2011,Private
Southern Methodist University,3613,39430,39430,0,0,800,7500,1000,1600,50330,50330,10900,10900,2011,Private
Southwestern Adventist University,3619,17080,17080,0,0,1142,6774,1390,1332,27718,27718,10638,10638,2011,Private
Southwestern Assemblies of God University,3616,15730,15730,0,0,1253,13220,1954,2615,34772,34772,19042,19042,2011,Private
Southwestern Christian College,3618,6858,6858,0,0,900,3684,800,600,12842,12842,5984,5984,2011,Private
Southwestern University,3620,33440,33440,0,0,1000,5480,450,950,41320,41320,7880,7880,2011,Private
St. Edward's University,3621,28700,28700,0,0,1100,8984,826,1790,41400,41400,12700,12700,2011,Private
St. Mary's University,3623,23426,23426,0,0,1300,4000,800,1810,31336,31336,7910,7910,2011,Private
Texas Christian University,3636,32490,32490,0,0,1050,10410,660,1500,46110,46110,13620,13620,2011,Private
Texas College,3638,9682,9682,0,0,1200,6400,2400,1758,21440,21440,11758,11758,2011,Private
Texas Lutheran University,3641,23930,23930,0,0,950,8200,1025,1100,35205,35205,11275,11275,2011,Private
Texas Wesleyan University,3645,19760,19760,0,0,1068,7200,1035,2250,31313,31313,11553,11553,2011,Private
The College of Saints John Fisher & Thomas More,420352,12800,12800,0,0,1200,1892,1802,1801,19495,19495,6695,6695,2011,Private
Trinity University,3647,31356,31356,0,0,1000,6597,200,900,40053,40053,8697,8697,2011,Private
University of Dallas,3651,29325,29325,0,0,1700,7700,2300,1700,42725,42725,13400,13400,2011,Private
University of Mary Hardin-Baylor,3588,22950,22950,0,0,1200,6220,1848,1282,33500,33500,10550,10550,2011,Private
University of St. Thomas,3654,25300,25300,0,0,1042,9596,2562,1968,40468,40468,15168,15168,2011,Private
University of the Incarnate Word,3578,22790,22790,0,0,1200,5662,1222,1638,32512,32512,9722,9722,2011,Private
Wayland Baptist University,3663,14190,14190,0,0,1300,9000,1600,1925,28015,28015,13825,13825,2011,Private
Wiley College,3669,11050,11050,0,0,0,6136,1000,600,18786,18786,7736,7736,2011,Private
Angelo State University,3541,7500,17320,0,0,1500,7484,2450,1750,20684,30504,13184,13184,2012,Public
Lamar University,3581,8544,20574,0,0,1520,7654,2386,2240,22344,34374,13800,13800,2012,Public
Midwestern State University,3592,7632,9582,0,0,1200,7088,1872,1598,19390,21340,11758,11758,2012,Public
Prairie View A&M University,3630,6900,15504,0,0,0,6976,1035,1035,15946,24550,9046,9046,2012,Public
Sam Houston State University,3606,8120,18650,0,0,1108,8608,3390,1770,22996,33526,14876,14876,2012,Public
Stephen F. Austin State University,3624,7928,18458,0,0,1146,8476,2899,1790,22239,32769,14311,14311,2012,Public
Sul Ross State University,3625,6060,15450,0,0,1320,10800,2972,1500,22652,32042,16592,16592,2012,Public
Sul Ross State University Rio Grande College,20,4146,13536,0,0,1320,9693,2277,1500,18936,28326,14790,14790,2012,Public
Tarleton State University,3631,6248,15638,0,0,1174,8858,1111,2270,19661,29051,13413,13413,2012,Public
Texas A&M International University,9651,6838,17368,0,0,1750,6275,1707,1575,18145,28675,11307,11307,2012,Public
Texas A&M University,3632,8480,25010,0,0,1272,8400,500,2234,20886,37416,12406,12406,2012,Public
Texas A&M University at Galveston,10298,7578,18608,0,0,1272,7800,500,2234,19384,30414,11806,11806,2012,Public
Texas A&M University-Central Texas,42295,6248,15638,0,0,1174,8858,1111,2270,19661,29051,13413,13413,2012,Public
Texas A&M University-Commerce,3565,6283,15673,0,0,1400,8106,2070,1867,19726,29116,13443,13443,2012,Public
Texas A&M University-Corpus Christi,11161,7668,18198,0,0,1241,6959,1656,1475,18999,29529,11331,11331,2012,Public
Texas A&M University-Kingsville,3639,6940,17470,0,0,1300,7086,2408,2762,20496,31026,13556,13556,2012,Public
Texas A&M University-San Antonio,42485,6666,17196,0,0,1300,7404,2408,2762,20540,31070,13874,13874,2012,Public
Texas A&M University-Texarkana,29269,5468,14948,0,0,1500,8386,2648,1749,19751,29231,14283,14283,2012,Public
Texas Southern University,3642,7646,16946,0,0,1450,12974,2230,2374,26674,35974,19028,19028,2012,Public
Texas State University,3615,8770,19300,0,0,1090,7740,1350,2180,21130,31660,12360,12360,2012,Public
Texas Tech University,3644,9242,19772,0,0,1200,8464,2300,2120,23326,33856,14084,14084,2012,Public
Texas Woman's University,3646,7050,17580,0,0,1050,6354,1206,2313,17973,28503,10923,10923,2012,Public
The University of Texas at Arlington,3656,9152,17524,0,0,1160,7708,2664,1574,22258,30630,13106,13106,2012,Public
The University of Texas at Austin,3658,9794,32506,0,0,904,10946,1242,2510,25396,48108,15602,15602,2012,Public
The University of Texas at Brownsville,30646,6153,16683,0,0,1258,11318,1886,1886,22501,33031,16348,16348,2012,Public
The University of Texas at Dallas,9741,11592,29266,0,0,1200,9250,2100,2000,26142,43816,14550,14550,2012,Public
The University of Texas at El Paso,3661,7044,17644,0,0,1418,11490,2100,1722,23774,34374,16730,16730,2012,Public
The University of Texas at San Antonio,10115,9004,19534,0,0,1000,8235,2760,1800,22799,33329,13795,13795,2012,Public
The University of Texas at Tyler,11163,7222,17752,0,0,1324,10288,1964,1266,22064,32594,14842,14842,2012,Public
The University of Texas Permian Basin,9930,6508,17308,0,0,915,4738,1773,2058,15992,26792,9484,9484,2012,Public
The University of Texas-Rio Grande Valley,3599,6124,16654,0,0,1000,7544,2924,1926,19518,30048,13394,13394,2012,Public
University of Houston,3652,9311,18159,0,0,1200,10200,2800,2700,26211,35059,16900,16900,2012,Public
University of Houston-Clear Lake,11711,6514,18364,0,0,1050,8354,3022,3356,22296,34146,15782,15782,2012,Public
University of Houston-Downtown,12826,5997,16527,0,0,1100,8600,3200,6198,25095,35625,19098,19098,2012,Public
University of Houston-Victoria,13231,6116,16646,0,0,1200,7722,2070,2054,19162,29692,13046,13046,2012,Public
University of North Texas,3594,9078,19608,0,0,1000,6886,2238,2000,21202,31732,12124,12124,2012,Public
University of North Texas at Dallas,42421,7350,17880,0,0,1000,6676,2238,2000,19264,29794,11914,11914,2012,Public
West Texas A&M University,3665,6709,7610,0,0,1000,6864,2300,2070,18943,19844,12234,12234,2012,Public
Abilene Christian University,3537,26770,26770,0,0,1100,8650,1450,1930,39900,39900,13130,13130,2012,Private
Amberton University,22594,7050,7050,0,0,0,0,0,0,7050,7050,0,0,2012,Private
Austin College,3543,32850,32850,0,0,1200,3820,500,800,39170,39170,6320,6320,2012,Private
Baylor University,3545,33916,33916,0,0,1364,10468,2444,3440,51632,51632,17716,17716,2012,Private
Concordia University Texas,3557,23600,23600,0,0,1480,5880,860,1420,33240,33240,9640,9640,2012,Private
Dallas Baptist University,3560,20910,20910,0,0,2220,9756,2844,1899,37629,37629,16719,16719,2012,Private
East Texas Baptist University,3564,21530,21530,0,0,920,4679,880,1477,29486,29486,7956,7956,2012,Private
Hardin-Simmons University,3571,22560,22560,0,0,800,6630,1098,1476,32564,32564,10004,10004,2012,Private
Houston Baptist University,3576,26795,26795,0,0,1350,7675,2508,2059,40387,40387,13592,13592,2012,Private
Howard Payne University,3575,22560,22560,0,0,1200,4020,1139,1677,30596,30596,8036,8036,2012,Private
Huston-Tillotson University,3577,13054,13054,0,0,1020,9396,2597,2782,28849,28849,15795,15795,2012,Private
Jarvis Christian College,3637,11370,11370,0,0,1300,7944,1200,1800,23614,23614,12244,12244,2012,Private
Letourneau University,3584,25145,25145,0,0,1471,9785,1284,1688,39373,39373,14228,14228,2012,Private
Lubbock Christian University,3586,17760,17760,0,0,1000,6674,2022,2262,29718,29718,11958,11958,2012,Private
McMurry University,3591,23480,23480,0,0,1200,5452,1968,1968,34068,34068,10588,10588,2012,Private
Our Lady of the Lake University of San Antonio,3598,23588,23588,0,0,1200,7434,1450,1850,35522,35522,11934,11934,2012,Private
Rice University,3604,37287,37287,0,0,800,12600,600,1550,52837,52837,15550,15550,2012,Private
Schreiner University,3610,21540,21540,0,0,1200,9360,1000,1000,34100,34100,12560,12560,2012,Private
Southern Methodist University,3613,41750,41750,0,0,800,7500,1000,1600,52650,52650,10900,10900,2012,Private
Southwestern Adventist University,3619,17800,17800,0,0,1200,6948,1542,1352,28842,28842,11042,11042,2012,Private
Southwestern Assemblies of God University,3616,16630,16630,0,0,1278,13484,1992,2702,36086,36086,19456,19456,2012,Private
Southwestern Christian College,3618,7720,7720,0,0,900,4052,800,600,14072,14072,6352,6352,2012,Private
Southwestern University,3620,34410,34410,0,0,1000,5640,450,950,42450,42450,8040,8040,2012,Private
St. Edward's University,3621,31110,31110,0,0,1100,9344,900,1846,44300,44300,13190,13190,2012,Private
St. Mary's University,3623,24226,24226,0,0,1300,4000,800,1600,31926,31926,7700,7700,2012,Private
Texas Christian University,3636,34590,34590,0,0,1200,10650,420,1500,48360,48360,13770,13770,2012,Private
Texas College,3638,9682,9682,0,0,1200,6400,2400,1758,21440,21440,11758,11758,2012,Private
Texas Lutheran University,3641,24990,24990,0,0,950,8200,1025,1100,36265,36265,11275,11275,2012,Private
Texas Wesleyan University,3645,20840,20840,0,0,1200,7425,1350,2340,33155,33155,12315,12315,2012,Private
The College of Saints John Fisher & Thomas More,420352,12800,12800,0,0,620,5065,1865,1865,22215,22215,9415,9415,2012,Private
Trinity University,3647,32868,32868,0,0,1000,8776,200,900,43744,43744,10876,10876,2012,Private
University of Dallas,3651,31070,31070,0,0,1700,7700,2300,1700,44470,44470,13400,13400,2012,Private
University of Mary Hardin-Baylor,3588,24150,24150,0,0,1200,6620,1748,1282,35000,35000,10850,10850,2012,Private
University of St. Thomas,3654,26890,26890,0,0,1078,9934,2652,2036,42590,42590,15700,15700,2012,Private
University of the Incarnate Word,3578,23690,23690,0,0,1200,5862,1252,1694,33698,33698,10008,10008,2012,Private
Wayland Baptist University,3663,14630,14630,0,0,1500,8550,1580,1992,28252,28252,13622,13622,2012,Private
Wiley College,3669,11050,11050,0,0,0,6620,800,1200,19670,19670,8620,8620,2012,Private
Angelo State University,3541,7575,17395,0,0,1200,7556,2000,1600,19931,29751,12356,12356,2013,Public
Lamar University,3581,8990,19610,0,0,1544,7774,2422,2408,23138,33758,14148,14148,2013,Public
Midwestern State University,3592,7764,9714,0,0,1200,7229,1909,1740,19842,21792,12078,12078,2013,Public
Prairie View A&M University,3630,6900,15504,0,0,0,6976,1035,1035,15946,24550,9046,9046,2013,Public
Sam Houston State University,3606,8594,19214,0,0,1124,8708,2000,1790,22216,32836,13622,13622,2013,Public
Stephen F. Austin State University,3624,8458,19578,0,0,1164,8609,2945,1818,22994,34114,14536,14536,2013,Public
Sul Ross State University,3625,6600,17220,0,0,1340,10968,3018,1522,23448,34068,16848,16848,2013,Public
Sul Ross State University Rio Grande College,20,4446,15066,0,0,1340,9846,2312,1522,19466,30086,15020,15020,2013,Public
Tarleton State University,3631,6659,17279,0,0,1174,9042,1111,1800,19786,30406,13127,13127,2013,Public
Texas A&M International University,9651,7142,17762,0,0,1750,6518,1829,1575,18814,29434,11672,11672,2013,Public
Texas A&M University,3632,9036,25656,0,0,1246,8450,500,2349,21581,38201,12545,12545,2013,Public
Texas A&M University at Galveston,10298,7805,18425,0,0,1246,9000,500,2349,20900,31520,13095,13095,2013,Public
Texas A&M University-Central Texas,42295,6659,17279,0,0,1174,9042,1111,1800,19786,30406,13127,13127,2013,Public
Texas A&M University-Commerce,3565,6664,17202,0,0,1400,8106,2070,1867,20107,30645,13443,13443,2013,Public
Texas A&M University-Corpus Christi,11161,7778,18398,0,0,1260,9879,1682,1498,22097,32717,14319,14319,2013,Public
Texas A&M University-Kingsville,3639,6940,17560,0,0,1300,7197,2446,2805,20688,31308,13748,13748,2013,Public
Texas A&M University-San Antonio,42485,6751,17281,0,0,1300,7520,2446,2805,20822,31352,14071,14071,2013,Public
Texas A&M University-Texarkana,29269,5998,16528,0,0,1400,8800,500,1000,17698,28228,11700,11700,2013,Public
Texas Southern University,3642,7875,17454,0,0,1493,13177,2265,2411,27221,36800,19346,19346,2013,Public
Texas State University,3615,9150,19770,0,0,800,6980,2070,1710,20710,31330,11560,11560,2013,Public
Texas Tech University,3644,9242,19862,0,0,1200,8464,2300,2120,23326,33946,14084,14084,2013,Public
Texas Woman's University,3646,7290,17910,0,0,1050,6507,1206,2313,18366,28986,11076,11076,2013,Public
The University of Texas at Arlington,3656,9152,17524,0,0,1160,7864,2732,1600,22508,30880,13356,13356,2013,Public
The University of Texas at Austin,3658,9790,33128,0,0,750,11362,1470,2776,26148,49486,16358,16358,2013,Public
The University of Texas at Brownsville,30646,6153,16683,0,0,1258,11318,1886,1886,22501,33031,16348,16348,2013,Public
The University of Texas at Dallas,9741,11806,30378,0,0,1200,9420,2140,2000,26566,45138,14760,14760,2013,Public
The University of Texas at El Paso,3661,7018,17639,0,0,1450,11744,2130,1748,24090,34711,17072,17072,2013,Public
The University of Texas at San Antonio,10115,9082,19800,0,0,1000,9423,2760,1836,24101,34819,15019,15019,2013,Public
The University of Texas at Tyler,11163,7222,17842,0,0,1540,10210,1996,1428,22396,33016,15174,15174,2013,Public
The University of Texas Permian Basin,9930,6776,17308,0,0,915,4918,1639,1924,16172,26704,9396,9396,2013,Public
The University of Texas-Rio Grande Valley,3599,6134,16891,0,0,1150,7278,3186,1944,19692,30449,13558,13558,2013,Public
University of Houston,3652,9888,18430,0,0,1200,10600,2800,2700,27188,35730,17300,17300,2013,Public
University of Houston-Clear Lake,11711,6810,19230,0,0,1050,8538,2846,3432,22676,35096,15866,15866,2013,Public
University of Houston-Downtown,12826,6267,16868,0,0,1100,8371,2790,3852,22380,32981,16113,16113,2013,Public
University of Houston-Victoria,13231,6248,16868,0,0,1200,7844,2102,2054,19448,30068,13200,13200,2013,Public
University of North Texas,3594,9426,19956,0,0,1000,7086,2336,2132,21980,32510,12554,12554,2013,Public
University of North Texas at Dallas,42421,7650,18180,0,0,1000,6900,2328,2060,19938,30468,12288,12288,2013,Public
West Texas A&M University,3665,6969,17589,0,0,1000,6896,2346,2110,19321,29941,12352,12352,2013,Public
Abilene Christian University,3537,28350,28350,0,0,1250,8800,1450,1950,41800,41800,13450,13450,2013,Private
Amberton University,22594,7260,7260,0,0,0,0,0,0,7260,7260,0,0,2013,Private
Austin College,3543,33830,33830,0,0,1250,3820,525,850,40275,40275,6445,6445,2013,Private
Baylor University,3545,36172,36172,0,0,1370,10632,2484,3494,54152,54152,17980,17980,2013,Private
Concordia University Texas,3557,25880,25880,0,0,1500,6060,860,1440,35740,35740,9860,9860,2013,Private
Dallas Baptist University,3560,22372,22372,0,0,2250,9963,2889,1926,39400,39400,17028,17028,2013,Private
East Texas Baptist University,3564,22590,22590,0,0,920,4772,880,1484,30646,30646,8056,8056,2013,Private
Hardin-Simmons University,3571,23460,23460,0,0,800,7154,1098,1476,33988,33988,10528,10528,2013,Private
Houston Baptist University,3576,27930,27930,0,0,1000,7982,2620,2141,41673,41673,13743,13743,2013,Private
Howard Payne University,3575,23200,23200,0,0,1200,4788,1155,1700,32043,32043,8843,8843,2013,Private
Huston-Tillotson University,3577,13054,13054,0,0,1040,9324,2651,2782,28851,28851,15797,15797,2013,Private
Jarvis Christian College,3637,12179,12179,0,0,1200,6400,2000,1500,23279,23279,11100,11100,2013,Private
Letourneau University,3584,26345,26345,0,0,1493,9938,1304,1714,40794,40794,14449,14449,2013,Private
Lubbock Christian University,3586,18740,18740,0,0,1100,6778,2052,2296,30966,30966,12226,12226,2013,Private
McMurry University,3591,24296,24296,0,0,1200,5452,2027,2028,35003,35003,10707,10707,2013,Private
Our Lady of the Lake University of San Antonio,3598,24098,24098,0,0,1200,7436,1450,1850,36034,36034,11936,11936,2013,Private
Rice University,3604,38941,38941,0,0,800,13000,600,1550,54891,54891,15950,15950,2013,Private
Schreiner University,3610,22484,22484,0,0,0,9830,1000,1000,34314,34314,11830,11830,2013,Private
Southern Methodist University,3613,43800,43800,0,0,0,7500,1000,1800,54100,54100,10300,10300,2013,Private
Southwestern Adventist University,3619,18640,18640,0,0,1300,6788,1410,1328,29466,29466,10826,10826,2013,Private
Southwestern Assemblies of God University,3616,17830,17830,0,0,1298,13694,2022,2742,37586,37586,19756,19756,2013,Private
Southwestern Christian College,3618,7841,7841,0,0,1016,4116,800,600,14373,14373,6532,6532,2013,Private
Southwestern University,3620,35240,35240,0,0,1200,5800,450,950,43640,43640,8400,8400,2013,Private
St. Edward's University,3621,33720,33720,0,0,1100,9934,900,1846,47500,47500,13780,13780,2013,Private
St. Mary's University,3623,25188,25188,0,0,1300,4000,1000,2000,33488,33488,8300,8300,2013,Private
Texas Christian University,3636,36590,36590,0,0,1050,11800,1120,1500,52060,52060,15470,15470,2013,Private
Texas College,3638,10008,10008,0,0,1200,7140,2800,1772,22920,22920,12912,12912,2013,Private
Texas Lutheran University,3641,25890,25890,0,0,950,8200,1025,1100,37165,37165,11275,11275,2013,Private
Texas Wesleyan University,3645,22040,22040,0,0,1200,8215,1400,2700,35555,35555,13515,13515,2013,Private
The College of Saints John Fisher & Thomas More,420352,10000,10000,0,0,1150,5065,1865,1865,19945,19945,9945,9945,2013,Private
Trinity University,3647,34678,34678,0,0,1000,9148,500,900,46226,46226,11548,11548,2013,Private
University of Dallas,3651,33010,33010,0,0,1200,8000,1600,1500,45310,45310,12300,12300,2013,Private
University of Mary Hardin-Baylor,3588,25200,25200,0,0,1200,6750,1748,1282,36180,36180,10980,10980,2013,Private
University of St. Thomas,3654,28240,28240,0,0,1094,10090,2694,2068,44186,44186,15946,15946,2013,Private
University of the Incarnate Word,3578,24790,24790,0,0,1200,8550,1270,1720,37530,37530,12740,12740,2013,Private
Wayland Baptist University,3663,15430,15430,0,0,1650,9600,1800,2190,30670,30670,15240,15240,2013,Private
Wiley College,3669,11382,11382,0,0,1500,6716,800,1200,21598,21598,10216,10216,2013,Private
Angelo State University,3541,7642,18502,0,0,1200,7602,1900,1580,19924,30784,12282,12282,2014,Public
Lamar University,3581,9340,20200,0,0,1200,7550,2400,1800,22290,33150,12950,12950,2014,Public
Midwestern State University,3592,8088,10038,0,0,1200,7374,1947,1783,20392,22342,12304,12304,2014,Public
Prairie View A&M University,3630,8637,20103,0,0,1300,7829,1500,2500,21766,33232,13129,13129,2014,Public
Sam Houston State University,3606,8932,19792,0,0,1124,8708,2000,1860,22624,33484,13692,13692,2014,Public
Stephen F. Austin State University,3624,8772,19632,0,0,1192,8868,3000,1854,23686,34546,14914,14914,2014,Public
Sul Ross State University,3625,6900,17760,0,0,1366,10476,3076,1552,23370,34230,16470,16470,2014,Public
Sul Ross State University Rio Grande College,20,4746,15606,0,0,1366,9558,2356,1552,19578,30438,14832,14832,2014,Public
Tarleton State University,3631,8108,18968,0,0,1207,8772,1111,1800,20998,31858,12890,12890,2014,Public
Texas A&M International University,9651,7558,18652,0,0,1780,6845,1864,1602,19649,30743,12091,12091,2014,Public
Texas A&M University,3632,9242,26356,0,0,1000,9522,606,2100,22470,39584,13228,13228,2014,Public
Texas A&M University at Galveston,10298,9630,20544,0,0,1000,10000,606,2098,23334,34248,13704,13704,2014,Public
Texas A&M University-Central Texas,42295,5592,14570,0,0,1350,9135,1440,1800,19317,28295,13725,13725,2014,Public
Texas A&M University-Commerce,3565,6753,17504,0,0,1400,8106,2070,1867,20196,30947,13443,13443,2014,Public
Texas A&M University-Corpus Christi,11161,8287,19113,0,0,1055,9114,1714,1527,21697,32523,13410,13410,2014,Public
Texas A&M University-Kingsville,3639,7434,18635,0,0,1300,7335,2493,2859,21421,32622,13987,13987,2014,Public
Texas A&M University-San Antonio,42485,7313,17869,0,0,1300,7664,2493,2859,21629,32185,14316,14316,2014,Public
Texas A&M University-Texarkana,29269,6622,17906,0,0,1400,9310,500,1000,18832,30116,12210,12210,2014,Public
Texas Southern University,3642,7875,17454,0,0,1522,13431,2310,2458,27596,37175,19721,19721,2014,Public
Texas State University,3615,9500,20360,0,0,810,7110,2100,1740,21260,32120,11760,11760,2014,Public
Texas Tech University,3644,9608,20468,0,0,1200,9384,2300,2120,24612,35472,15004,15004,2014,Public
Texas Woman's University,3646,7560,18420,0,0,1050,6624,1224,2349,18807,29667,11247,11247,2014,Public
The University of Texas at Arlington,3656,9380,18068,0,0,1206,8156,2776,1624,23142,31830,13762,13762,2014,Public
The University of Texas at Austin,3658,9798,33842,0,0,750,11456,1490,2820,26314,50358,16516,16516,2014,Public
The University of Texas at Brownsville,30646,5928,16844,0,0,1196,6250,1401,1917,16692,27608,10764,10764,2014,Public
The University of Texas at Dallas,9741,11806,30378,0,0,1200,9548,2140,2040,26734,45306,14928,14928,2014,Public
The University of Texas at El Paso,3661,7018,17639,0,0,1452,11970,2302,1782,24524,35145,17506,17506,2014,Public
The University of Texas at San Antonio,10115,9082,19800,0,0,1000,9423,2760,1836,24101,34819,15019,15019,2014,Public
The University of Texas at Tyler,11163,7312,18172,0,0,1580,11552,2034,1460,23938,34798,16626,16626,2014,Public
The University of Texas Permian Basin,9930,6776,17308,0,0,915,4918,1639,1924,16172,26704,9396,9396,2014,Public
The University of Texas-Rio Grande Valley,3599,6134,17132,0,0,1150,6818,3204,2014,19320,30318,13186,13186,2014,Public
University of Houston,3652,10331,24378,0,0,1200,10800,2800,2700,27831,41878,17500,17500,2014,Public
University of Houston-Clear Lake,11711,7131,20091,0,0,1050,9682,2992,3558,24413,37373,17282,17282,2014,Public
University of Houston-Downtown,12826,6614,17474,0,0,1167,8532,2844,3926,23083,33943,16469,16469,2014,Public
University of Houston-Victoria,13231,6748,17608,0,0,1200,7996,2102,2076,20122,30982,13374,13374,2014,Public
University of North Texas,3594,10066,20926,0,0,1000,7376,2336,2062,22840,33700,12774,12774,2014,Public
University of North Texas at Dallas,42421,7860,18720,0,0,1000,7126,2328,2060,20374,31234,12514,12514,2014,Public
West Texas A&M University,3665,7361,18842,0,0,1000,7196,2392,2150,20099,31580,12738,12738,2014,Public
Abilene Christian University,3537,29450,29450,0,0,1250,9000,1450,1950,43100,43100,13650,13650,2014,Private
Amberton University,22594,7260,7260,0,0,0,0,0,0,7260,7260,0,0,2014,Private
Austin College,3543,34840,34840,0,0,1250,3830,525,850,41295,41295,6455,6455,2014,Private
Baylor University,3545,38320,38320,0,0,1250,10560,1150,2880,54160,54160,15840,15840,2014,Private
Concordia University Texas,3557,26960,26960,0,0,1520,6040,860,1460,36840,36840,9880,9880,2014,Private
Dallas Baptist University,3560,23774,23774,0,0,2280,10188,2943,1962,41147,41147,17373,17373,2014,Private
East Texas Baptist University,3564,23280,23280,0,0,938,4864,896,1512,31490,31490,8210,8210,2014,Private
Hardin-Simmons University,3571,22350,22350,0,0,1000,6962,1598,1976,33886,33886,11536,11536,2014,Private
Houston Baptist University,3576,28800,28800,0,0,0,8300,2738,2228,42066,42066,13266,13266,2014,Private
Howard Payne University,3575,24600,24600,0,0,1200,4880,1177,1732,33589,33589,8989,8989,2014,Private
Huston-Tillotson University,3577,13544,13544,0,0,1040,7514,2650,2782,27530,27530,13986,13986,2014,Private
Jarvis Christian College,3637,12179,12179,0,0,0,6400,2000,1500,22079,22079,9900,9900,2014,Private
Letourneau University,3584,27560,27560,0,0,1520,10128,1328,1746,42282,42282,14722,14722,2014,Private
Lubbock Christian University,3586,19400,19400,0,0,1100,6908,2092,2340,31840,31840,12440,12440,2014,Private
McMurry University,3591,25019,25019,0,0,1200,5452,2027,2028,35726,35726,10707,10707,2014,Private
Our Lady of the Lake University of San Antonio,3598,24596,24596,0,0,1200,7436,1450,1850,36532,36532,11936,11936,2014,Private
Rice University,3604,40566,40566,0,0,800,13400,600,1550,56916,56916,16350,16350,2014,Private
Schreiner University,3610,24359,24359,0,0,100,9830,1000,1000,36289,36289,11930,11930,2014,Private
Southern Methodist University,3613,45940,45940,0,0,800,8500,1000,1876,58116,58116,12176,12176,2014,Private
Southwestern Adventist University,3619,19460,19460,0,0,1368,6902,1416,1346,30492,30492,11032,11032,2014,Private
Southwestern Assemblies of God University,3616,18580,18580,0,0,1298,13694,2022,2742,38336,38336,19756,19756,2014,Private
Southwestern Christian College,3618,7963,7963,0,0,1016,4195,800,600,14574,14574,6611,6611,2014,Private
Southwestern University,3620,36120,36120,0,0,1200,6000,450,950,44720,44720,8600,8600,2014,Private
St. Edward's University,3621,36550,36550,0,0,1000,10392,900,1758,50600,50600,14050,14050,2014,Private
St. Mary's University,3623,26186,26186,0,0,1300,4000,1000,2000,34486,34486,8300,8300,2014,Private
Texas Christian University,3636,38600,38600,0,0,1050,11380,1200,1500,53730,53730,15130,15130,2014,Private
Texas College,3638,10008,10008,0,0,1200,7140,2800,1772,22920,22920,12912,12912,2014,Private
Texas Lutheran University,3641,26800,26800,0,0,950,8200,1025,1100,38075,38075,11275,11275,2014,Private
Texas Wesleyan University,3645,23144,23144,0,0,1200,8216,1850,2700,37110,37110,13966,13966,2014,Private
Trinity University,3647,36214,36214,0,0,1000,9514,500,900,48128,48128,11914,11914,2014,Private
University of Dallas,3651,34430,34430,0,0,1200,8000,1600,1500,46730,46730,12300,12300,2014,Private
University of Mary Hardin-Baylor,3588,25650,25650,0,0,1300,7020,1748,1282,37000,37000,11350,11350,2014,Private
University of St. Thomas,3654,29440,29440,0,0,1094,10090,2694,2068,45386,45386,15946,15946,2014,Private
University of the Incarnate Word,3578,26490,26490,0,0,1200,9510,1294,1752,40246,40246,13756,13756,2014,Private
Wayland Baptist University,3663,15930,15930,0,0,1650,9784,1834,2232,31430,31430,15500,15500,2014,Private
Wiley College,3669,11382,11382,0,0,1500,6716,800,1200,21598,21598,10216,10216,2014,Private
Angelo State University,3541,7802,18662,0,0,1200,7702,1900,1580,20184,31044,12382,12382,2015,Public
Lamar University,3581,9700,21400,0,0,1000,7550,2400,1800,22450,34150,12750,12750,2015,Public
Midwestern State University,3592,8305,10255,0,0,1350,8027,1986,1818,21486,23436,13181,13181,2015,Public
Prairie View A&M University,3630,9645,22171,0,0,1300,7343,1530,2551,22369,34895,12724,12724,2015,Public
Sam Houston State University,3606,9336,21036,0,0,1124,8708,2000,1860,23028,34728,13692,13692,2015,Public
Stephen F. Austin State University,3624,9312,20892,0,0,1192,8868,1600,1854,22826,34406,13514,13514,2015,Public
Sul Ross State University,3625,7211,18911,0,0,1366,8560,2628,1552,21317,33017,14106,14106,2015,Public
Sul Ross State University Rio Grande College,20,4960,16660,0,0,1366,7804,1992,1552,17674,29374,12714,12714,2015,Public
Tarleton State University,3631,8213,19913,0,0,1207,9324,1133,1836,21713,33413,13500,13500,2015,Public
Texas A&M International University,9651,7990,19894,0,0,1820,7065,1902,1635,20412,32316,12422,12422,2015,Public
Texas A&M University,3632,9494,28084,0,0,1194,10338,622,2378,24026,42616,14532,14532,2015,Public
Texas A&M University at Galveston,10298,10052,22260,0,0,1194,10270,622,2378,24516,36724,14464,14464,2015,Public
Texas A&M University-Central Texas,42295,5815,15638,0,0,1350,9135,1440,1800,19540,29363,13725,13725,2015,Public
Texas A&M University-Commerce,3565,7264,18302,0,0,1400,8546,2070,1867,21147,32185,13883,13883,2015,Public
Texas A&M University-Corpus Christi,11161,8620,20495,0,0,1076,9544,1749,1558,22547,34422,13927,13927,2015,Public
Texas A&M University-Kingsville,3639,7700,20190,0,0,1344,7343,2296,2472,21155,33645,13455,13455,2015,Public
Texas A&M University-San Antonio,42485,7454,18709,0,0,1326,7820,2544,2917,22061,33316,14607,14607,2015,Public
Texas A&M University-Texarkana,29269,7036,19568,0,0,1400,6840,500,1000,16776,29308,9740,9740,2015,Public
Texas Southern University,3642,8126,15596,0,0,1524,13445,2311,2460,27866,35336,19740,19740,2015,Public
Texas State University,3615,9940,21640,0,0,820,7250,2140,1770,21920,33620,11980,11980,2015,Public
Texas Tech University,3644,9866,20726,0,0,1200,9384,2300,2120,24870,35730,15004,15004,2015,Public
Texas Woman's University,3646,8522,20222,0,0,1050,6750,1248,2394,19964,31664,11442,11442,2015,Public
The University of Texas at Arlington,3656,9380,18068,0,0,1206,8398,2852,1660,23496,32184,14116,14116,2015,Public
The University of Texas at Austin,3658,9810,34806,0,0,750,11456,1490,2820,26326,51322,16516,16516,2015,Public
The University of Texas at Brownsville,30646,7292,18272,0,0,1194,6946,3186,2036,20654,31634,13362,13362,2015,Public
The University of Texas at Dallas,9741,11806,31328,0,0,1200,9988,2140,2040,27174,46696,15368,15368,2015,Public
The University of Texas at El Paso,3661,7059,18758,0,0,1485,11768,2210,1818,24340,36039,17281,17281,2015,Public
The University of Texas at San Antonio,10115,9361,20674,0,0,1000,9558,2760,1836,24515,35828,15154,15154,2015,Public
The University of Texas at Tyler,11163,7312,19236,0,0,1252,9550,2034,1460,21608,33532,14296,14296,2015,Public
The University of Texas Permian Basin,9930,6776,17626,0,0,915,4918,1639,1924,16172,27022,9396,9396,2015,Public
The University of Texas-Rio Grande Valley,3599,7292,18992,0,0,1194,6946,3186,2036,20654,32354,13362,13362,2015,Public
University of Houston,3652,10331,24378,0,0,1300,11060,2800,2700,28191,42238,17860,17860,2015,Public
University of Houston-Clear Lake,11711,7473,21093,0,0,1050,9588,3018,3138,24267,37887,16794,16794,2015,Public
University of Houston-Downtown,12826,6938,18638,0,0,1190,8706,2902,4006,23742,35442,16804,16804,2015,Public
University of Houston-Victoria,13231,7086,18786,0,0,1200,7996,2102,2076,20460,32160,13374,13374,2015,Public
University of North Texas,3594,10480,22180,0,0,1000,7524,2260,2062,23326,35026,12846,12846,2015,Public
University of North Texas at Dallas,42421,7850,19550,0,0,1200,7388,2446,2160,21044,32744,13194,13194,2015,Public
West Texas A&M University,3665,7514,20046,0,0,1000,7196,2392,2150,20252,32784,12738,12738,2015,Public
Abilene Christian University,3537,30830,30830,0,0,1250,9310,1450,1900,44740,44740,13910,13910,2015,Private
Amberton University,22594,7500,7500,0,0,0,0,0,0,7500,7500,0,0,2015,Private
Austin College,3543,36230,36230,0,0,1250,3830,525,850,42685,42685,6455,6455,2015,Private
Baylor University,3545,40398,40398,0,0,1276,11140,1174,2788,56776,56776,16378,16378,2015,Private
Concordia University Texas,3557,28160,28160,0,0,1274,7204,1656,1484,39778,39778,11618,11618,2015,Private
Dallas Baptist University,3560,25016,25016,0,0,1260,10440,2943,1998,41657,41657,16641,16641,2015,Private
East Texas Baptist University,3564,24218,24218,0,0,956,4960,914,1542,32590,32590,8372,8372,2015,Private
Hardin-Simmons University,3571,24500,24500,0,0,800,7740,1200,1976,36216,36216,11716,11716,2015,Private
Houston Baptist University,3576,29600,29600,0,0,1000,8630,2862,2448,44540,44540,14940,14940,2015,Private
Howard Payne University,3575,25600,25600,0,0,1200,5400,1200,1768,35168,35168,9568,9568,2015,Private
Huston-Tillotson University,3577,14346,14346,0,0,1040,7514,2650,2782,28332,28332,13986,13986,2015,Private
Jarvis Christian College,3637,11720,11720,0,0,1000,6400,1800,1200,22120,22120,10400,10400,2015,Private
Letourneau University,3584,28550,28550,0,0,1550,10332,1354,1782,43568,43568,15018,15018,2015,Private
Lubbock Christian University,3586,20360,20360,0,0,1100,7048,2134,2388,33030,33030,12670,12670,2015,Private
McMurry University,3591,25763,25763,0,0,1200,5452,2027,3028,37470,37470,11707,11707,2015,Private
Our Lady of the Lake University of San Antonio,3598,26148,26148,0,0,1200,7556,1450,1850,38204,38204,12056,12056,2015,Private
Rice University,3604,42253,42253,0,0,800,13650,600,1550,58853,58853,16600,16600,2015,Private
Schreiner University,3610,25086,25086,0,0,100,9830,1000,1000,37016,37016,11930,11930,2015,Private
Southern Methodist University,3613,48190,48190,0,0,800,8500,1000,1876,60366,60366,12176,12176,2015,Private
Southwestern Adventist University,3619,19916,19916,0,0,1400,7108,1328,1356,31108,31108,11192,11192,2015,Private
Southwestern Assemblies of God University,3616,19180,19180,0,0,1298,13694,2022,2742,38936,38936,19756,19756,2015,Private
Southwestern Christian College,3618,7963,7963,0,0,1016,4195,800,600,14574,14574,6611,6611,2015,Private
Southwestern University,3620,37560,37560,0,0,1200,10570,900,950,51180,51180,13620,13620,2015,Private
St. Edward's University,3621,38720,38720,0,0,1150,10630,910,1790,53200,53200,14480,14480,2015,Private
St. Mary's University,3623,27160,27160,0,0,1300,4000,1000,2000,35460,35460,8300,8300,2015,Private
Texas Christian University,3636,40720,40720,0,0,1050,11800,1200,3500,58270,58270,17550,17550,2015,Private
Texas College,3638,10008,10008,0,0,2400,8000,3000,1900,25308,25308,15300,15300,2015,Private
Texas Lutheran University,3641,27900,27900,0,0,950,8446,1025,1100,39421,39421,11521,11521,2015,Private
Texas Wesleyan University,3645,24454,24454,0,0,1600,8600,1850,2800,39304,39304,14850,14850,2015,Private
Trinity University,3647,37856,37856,0,0,1000,9576,500,900,49832,49832,11976,11976,2015,Private
University of Dallas,3651,35800,35800,0,0,1200,8500,1800,1400,48700,48700,12900,12900,2015,Private
University of Mary Hardin-Baylor,3588,26100,26100,0,0,1300,7300,1748,1282,37730,37730,11630,11630,2015,Private
University of St. Thomas,3654,30310,30310,0,0,1094,10090,2694,2068,46256,46256,15946,15946,2015,Private
University of the Incarnate Word,3578,27798,27798,0,0,1200,9700,1320,1788,41806,41806,14008,14008,2015,Private
Wayland Baptist University,3663,16980,16980,0,0,1650,11000,1850,2234,33714,33714,16734,16734,2015,Private
Wiley College,3669,11482,11482,0,0,1400,6430,1320,1428,22060,22060,10578,10578,2015,Private
Angelo State University,3541,8038,20278,0,0,1200,7666,1900,1580,20384,32624,12346,12346,2016,Public
Lamar University,3581,9716,21434,0,0,1000,7550,2400,1800,22466,34184,12750,12750,2016,Public
Midwestern State University,3592,8620,10570,0,0,1350,8012,1986,1830,21798,23748,13178,13178,2016,Public
Prairie View A&M University,3630,9979,23298,0,0,1302,7355,1532,2555,22723,36042,12744,12744,2016,Public
Sam Houston State University,3606,9514,21754,0,0,1372,8720,2004,1862,23472,35712,13958,13958,2016,Public
Stephen F. Austin State University,3624,9538,21238,0,0,1192,8868,1600,1854,23052,34752,13514,13514,2016,Public
Sul Ross State University,3625,7818,20058,0,0,1366,8802,2490,1552,22028,34268,14210,14210,2016,Public
Sul Ross State University Rio Grande College,20,5184,17424,0,0,1366,7695,1896,1552,17693,29933,12509,12509,2016,Public
Tarleton State University,3631,8286,20526,0,0,1207,10126,1135,1839,22593,34833,14307,14307,2016,Public
Texas A&M International University,9651,8446,20338,0,0,1820,6910,1040,1532,19748,31640,11302,11302,2016,Public
Texas A&M University,3632,9707,28709,0,0,1054,10368,2282,3474,26885,45887,17178,17178,2016,Public
Texas A&M University at Galveston,10298,10752,24930,0,0,1054,11728,2070,3474,29078,43256,18326,18326,2016,Public
Texas A&M University-Central Texas,42295,6260,16872,0,0,1080,9135,1440,1800,19715,30327,13455,13455,2016,Public
Texas A&M University-Commerce,3565,7750,19990,0,0,1400,8855,2070,1868,21943,34183,14193,14193,2016,Public
Texas A&M University-Corpus Christi,11161,9105,21486,0,0,1260,9196,2029,1807,23397,35778,14292,14292,2016,Public
Texas A&M University-Kingsville,3639,8050,21354,0,0,1344,7466,2296,2472,21628,34932,13578,13578,2016,Public
Texas A&M University-San Antonio,42485,8070,19307,0,0,1328,7833,2548,2922,22701,33938,14631,14631,2016,Public
Texas A&M University-Texarkana,29269,6649,18576,0,0,1400,9532,1037,1000,19618,31545,12969,12969,2016,Public
Texas Southern University,3642,9162,21447,0,0,1569,13713,2356,2509,29309,41594,20147,20147,2016,Public
Texas State University,3615,10200,22440,0,0,820,7260,2140,1770,22190,34430,11990,11990,2016,Public
Texas Tech University,3644,10622,22862,0,0,1200,9384,2300,2120,25626,37866,15004,15004,2016,Public
Texas Woman's University,3646,8790,22530,0,0,1050,6885,1269,2439,20433,34173,11643,11643,2016,Public
The University of Texas at Arlington,3656,9616,22920,0,0,1206,8410,2852,1660,23744,37048,14128,14128,2016,Public
The University of Texas at Austin,3658,9810,34806,0,0,662,10070,1490,2820,24852,49848,15042,15042,2016,Public
The University of Texas at Dallas,9741,12162,33654,0,0,1200,10190,2140,2040,27732,49224,15570,15570,2016,Public
The University of Texas at El Paso,3661,7348,20031,0,0,1485,12116,2400,1892,25241,37924,17893,17893,2016,Public
The University of Texas at San Antonio,10115,9677,22383,0,0,1000,9558,2760,1836,24831,37537,15154,15154,2016,Public
The University of Texas at Tyler,11163,7602,20082,0,0,1292,9970,2360,1624,22848,35328,15246,15246,2016,Public
The University of Texas Permian Basin,9930,6850,7970,0,0,1000,10800,1670,1960,22280,23400,15430,15430,2016,Public
The University of Texas-Rio Grande Valley,3599,7448,19688,0,0,1210,7670,2126,2044,20498,32738,13050,13050,2016,Public
University of Houston,3652,11078,23424,0,0,1300,11067,2804,2704,28953,41299,17875,17875,2016,Public
University of Houston-Clear Lake,11711,7931,22901,0,0,1064,9704,3234,3666,25599,40569,17668,17668,2016,Public
University of Houston-Downtown,12826,7181,19421,0,0,1210,8720,2906,4012,24029,36269,16848,16848,2016,Public
University of Houston-Victoria,13231,7368,19608,0,0,1200,7996,2102,2076,20742,32982,13374,13374,2016,Public
University of North Texas,3594,10910,23150,0,0,1000,7960,2260,2116,24246,36486,13336,13336,2016,Public
University of North Texas at Dallas,42421,7848,20088,0,0,1200,7592,2470,2160,21270,33510,13422,13422,2016,Public
West Texas A&M University,3665,7666,20791,0,0,1000,7196,2392,2150,20404,33529,12738,12738,2016,Public
Abilene Christian University,3537,32070,32070,0,0,1250,9730,1450,1830,46330,46330,14260,14260,2016,Private
Amberton University,22594,7500,7500,0,0,1600,0,0,0,9100,9100,1600,1600,2016,Private
Austin College,3543,37315,37315,0,0,1250,3830,525,850,43770,43770,6455,6455,2016,Private
Baylor University,3545,42206,42206,0,0,1444,10576,1876,2554,58656,58656,16450,16450,2016,Private
Concordia University Texas,3557,29460,29460,0,0,1274,7204,1656,1484,41078,41078,11618,11618,2016,Private
Dallas Baptist University,3560,26306,26306,0,0,1260,10692,2961,2007,43226,43226,16920,16920,2016,Private
East Texas Baptist University,3564,24700,24700,0,0,958,4968,914,1544,33084,33084,8384,8384,2016,Private
Hardin-Simmons University,3571,25830,25830,0,0,800,8138,1200,1976,37944,37944,12114,12114,2016,Private
Houston Baptist University,3576,30800,30800,0,0,1000,8973,2992,2542,46307,46307,15507,15507,2016,Private
Howard Payne University,3575,26630,26630,0,0,1200,5600,1200,1770,36400,36400,9770,9770,2016,Private
Huston-Tillotson University,3577,14346,14346,0,0,1040,7514,2650,2782,28332,28332,13986,13986,2016,Private
Jarvis Christian College,3637,11720,11720,0,0,1000,6400,1800,1200,22120,22120,10400,10400,2016,Private
Letourneau University,3584,29130,29130,0,0,1550,10332,1354,1782,44148,44148,15018,15018,2016,Private
Lubbock Christian University,3586,21166,21166,0,0,1100,7260,2198,2460,34184,34184,13018,13018,2016,Private
McMurry University,3591,26275,26275,0,0,1200,5452,2027,3028,37982,37982,11707,11707,2016,Private
Our Lady of the Lake University of San Antonio,3598,27140,27140,0,0,1200,7872,1450,1850,39512,39512,12372,12372,2016,Private
Rice University,3604,43918,43918,0,0,800,13750,600,2050,61118,61118,17200,17200,2016,Private
Schreiner University,3610,25750,25750,0,0,100,9830,1000,1000,37680,37680,11930,11930,2016,Private
Southern Methodist University,3613,50358,50358,0,0,800,8700,1000,1676,62534,62534,12176,12176,2016,Private
Southwestern Adventist University,3619,20276,20276,0,0,1500,7306,1196,1370,31648,31648,11372,11372,2016,Private
Southwestern Assemblies of God University,3616,19480,19480,0,0,1298,13694,2022,2742,39236,39236,19756,19756,2016,Private
Southwestern Christian College,3618,8208,8208,0,0,1050,4329,800,600,14987,14987,6779,6779,2016,Private
Southwestern University,3620,39060,39060,0,0,1300,10920,900,950,53130,53130,14070,14070,2016,Private
St. Edward's University,3621,40828,40828,0,0,1050,11122,910,1890,55800,55800,14972,14972,2016,Private
St. Mary's University,3623,28200,28200,0,0,1300,4000,1000,2000,36500,36500,8300,8300,2016,Private
Texas Christian University,3636,42670,42670,0,0,1050,12000,1200,3500,60420,60420,17750,17750,2016,Private
Texas College,3638,10008,10008,0,0,1200,7600,3000,1800,23608,23608,13600,13600,2016,Private
Texas Lutheran University,3641,28910,28910,0,0,950,8780,1500,1100,41240,41240,12330,12330,2016,Private
Texas Wesleyan University,3645,26050,26050,0,0,1800,8600,1850,2800,41100,41100,15050,15050,2016,Private
Trinity University,3647,39560,39560,0,0,1000,9864,500,900,51824,51824,12264,12264,2016,Private
University of Dallas,3651,37230,37230,0,0,1200,8500,1800,1400,50130,50130,12900,12900,2016,Private
University of Mary Hardin-Baylor,3588,26550,26550,0,0,1300,7590,1748,1282,38470,38470,11920,11920,2016,Private
University of St. Thomas,3654,31520,31520,0,0,1094,10090,2694,2068,47466,47466,15946,15946,2016,Private
University of the Incarnate Word,3578,28898,28898,0,0,1200,10794,1594,1822,44308,44308,15410,15410,2016,Private
Wayland Baptist University,3663,18510,18510,0,0,1000,11000,2000,2256,34766,34766,16256,16256,2016,Private
Wiley College,3669,12064,12064,0,0,1400,6490,1400,1566,22920,22920,10856,10856,2016,Private
Angelo State University,3541,8216,20751,0,0,1200,7702,1900,1580,20598,33133,12382,12382,2017,Public
Lamar University,3581,10092,22630,0,0,1012,7632,2424,1812,22972,35510,12880,12880,2017,Public
Midwestern State University,3592,8694,10644,0,0,1050,8534,2026,1868,22172,24122,13478,13478,2017,Public
Prairie View A&M University,3630,9979,23298,0,0,1302,7355,1532,2555,22723,36042,12744,12744,2017,Public
Sam Houston State University,3606,9890,22340,0,0,1372,11664,2004,1862,26792,39242,16902,16902,2017,Public
Stephen F. Austin State University,3624,9538,21778,0,0,1204,8868,1616,1873,23099,35339,13561,13561,2017,Public
Sul Ross State University,3625,8072,20522,0,0,1366,8802,2490,1552,22282,34732,14210,14210,2017,Public
Sul Ross State University Rio Grande College,20,5365,17815,0,0,1366,7695,1896,1552,17874,30324,12509,12509,2017,Public
Tarleton State University,3631,8417,20657,0,0,1207,10598,1146,1857,23225,35465,14808,14808,2017,Public
Texas A&M International University,9651,8320,21455,0,0,1200,7298,1050,1546,19414,32549,11094,11094,2017,Public
Texas A&M University,3632,9882,29986,0,0,1054,10368,2282,3474,27060,47164,17178,17178,2017,Public
Texas A&M University at Galveston,10298,10540,24644,0,0,1054,13168,2946,2596,30304,44408,19764,19764,2017,Public
Texas A&M University-Central Texas,42295,6386,17568,0,0,1200,9135,1440,1800,19961,31143,13575,13575,2017,Public
Texas A&M University-Commerce,3565,8434,20884,0,0,1400,8855,2070,1868,22627,35077,14193,14193,2017,Public
Texas A&M University-Corpus Christi,11161,8566,22131,0,0,1180,9666,2049,1825,23286,36851,14720,14720,2017,Public
Texas A&M University-Kingsville,3639,8462,22034,0,0,1344,10350,2319,2497,24972,38544,16510,16510,2017,Public
Texas A&M University-San Antonio,42485,8216,19654,0,0,1342,7912,2574,2952,22996,34434,14780,14780,2017,Public
Texas A&M University-Texarkana,29269,7347,17228,0,0,1400,9854,1037,1000,20638,30519,13291,13291,2017,Public
Texas Southern University,3642,9172,21620,0,0,1569,13713,2356,2506,29316,41764,20144,20144,2017,Public
Texas State University,3615,10620,23060,0,0,770,8420,1880,1570,23260,35700,12640,12640,2017,Public
Texas Tech University,3644,10772,23012,0,0,1200,9384,2300,2120,25776,38016,15004,15004,2017,Public
Texas Woman's University,3646,9360,21540,0,0,1050,6993,1269,2439,21111,33291,11751,11751,2017,Public
The University of Texas at Arlington,3656,9952,24402,0,0,1206,8924,2894,1684,24660,39110,14708,14708,2017,Public
The University of Texas at Austin,3658,10092,35682,0,0,662,10070,1490,2820,25134,50724,15042,15042,2017,Public
The University of Texas at Dallas,9741,12162,33654,0,0,1200,10748,2140,2040,28290,49782,16128,16128,2017,Public
The University of Texas at El Paso,3661,7651,21396,0,0,1862,12192,2264,1968,25937,39682,18286,18286,2017,Public
The University of Texas at San Antonio,10115,10013,23263,0,0,1500,9558,2760,1836,25667,38917,15654,15654,2017,Public
The University of Texas at Tyler,11163,7822,20872,0,0,1292,7486,2360,2160,21120,34170,13298,13298,2017,Public
The University of Texas Permian Basin,9930,7124,8174,0,0,1000,10800,1670,1960,22554,23604,15430,15430,2017,Public
The University of Texas-Rio Grande Valley,3599,7587,20037,0,0,1210,7943,2149,2091,20980,33430,13393,13393,2017,Public
University of Houston,3652,11078,23424,0,0,1300,11066,2804,2704,28952,41298,17874,17874,2017,Public
University of Houston-Clear Lake,11711,8188,23668,0,0,1064,9732,2760,3644,25388,40868,17200,17200,2017,Public
University of Houston-Downtown,12826,7451,19691,0,0,1210,8806,2936,4052,24455,36695,17004,17004,2017,Public
University of Houston-Victoria,13231,7627,20077,0,0,1200,7996,2102,2076,21001,33451,13374,13374,2017,Public
University of North Texas,3594,11296,24106,0,0,1000,8200,2260,2158,24914,37724,13618,13618,2017,Public
University of North Texas at Dallas,42421,7848,20298,0,0,1500,7668,2494,2182,21692,34142,13844,13844,2017,Public
West Texas A&M University,3665,8128,22073,0,0,1000,7196,2392,2150,20866,34811,12738,12738,2017,Public
Abilene Christian University,3537,33380,33380,0,0,1250,10378,1450,1822,48280,48280,14900,14900,2017,Private
Amberton University,22594,7990,0,0,0,0,0,0,0,7990,0,0,0,2017,Private
Austin College,3543,38800,38800,0,0,1250,4195,525,850,45620,45620,6820,6820,2017,Private
Baylor University,3545,44040,44040,0,0,1200,11448,1840,1846,60374,60374,16334,16334,2017,Private
Concordia University Texas,3557,30600,30600,0,0,1274,7204,1656,1484,42218,42218,11618,11618,2017,Private
Dallas Baptist University,3560,27606,27606,0,0,1290,10899,2988,2025,44808,44808,17202,17202,2017,Private
East Texas Baptist University,3564,25470,25470,0,0,800,5018,914,1544,33746,33746,8276,8276,2017,Private
Hardin-Simmons University,3571,27440,27440,0,0,800,8420,1200,1976,39836,39836,12396,12396,2017,Private
Houston Baptist University,3576,31730,31730,0,0,1000,9329,2992,2639,47690,47690,15960,15960,2017,Private
Howard Payne University,3575,27690,27690,0,0,1200,5656,1200,1770,37516,37516,9826,9826,2017,Private
Huston-Tillotson University,3577,14426,14426,0,0,1000,7650,1000,500,24576,24576,10150,10150,2017,Private
Jarvis Christian College,3637,11720,11720,0,0,1000,6400,1800,1200,22120,22120,10400,10400,2017,Private
Letourneau University,3584,29970,29970,0,0,1564,10436,1368,1798,45136,45136,15166,15166,2017,Private
Lubbock Christian University,3586,21794,21794,0,0,1250,7478,2264,2534,35320,35320,13526,13526,2017,Private
McMurry University,3591,26712,26712,0,0,1200,5452,2027,3028,38419,38419,11707,11707,2017,Private
Our Lady of the Lake University of San Antonio,3598,28241,28241,0,0,1200,10322,1450,1850,43063,43063,14822,14822,2017,Private
Rice University,3604,45608,45608,0,0,1200,13850,700,2500,63858,63858,18250,18250,2017,Private
Schreiner University,3610,26750,26750,0,0,0,9830,1000,1000,38580,38580,11830,11830,2017,Private
Southern Methodist University,3613,52498,52498,0,0,800,8700,1000,1676,64674,64674,12176,12176,2017,Private
Southwestern Adventist University,3619,20732,20732,0,0,1550,7306,1162,1400,32150,32150,11418,11418,2017,Private
Southwestern Assemblies of God University,3616,19994,19994,0,0,1310,13830,2042,2768,39944,39944,19950,19950,2017,Private
Southwestern Christian College,3618,8208,8208,0,0,1050,4329,800,600,14987,14987,6779,6779,2017,Private
Southwestern University,3620,40560,40560,0,0,1300,11210,930,980,54980,54980,14420,14420,2017,Private
St. Edward's University,3621,43050,43050,0,0,900,11900,960,1890,58700,58700,15650,15650,2017,Private
St. Mary's University,3623,29300,29300,0,0,1300,4000,1000,2000,37600,37600,8300,8300,2017,Private
Texas Christian University,3636,44760,44760,0,0,970,12360,1280,3600,62970,62970,18210,18210,2017,Private
Texas College,3638,10008,10008,0,0,2400,7600,3000,1800,24808,24808,14800,14800,2017,Private
Texas Lutheran University,3641,29960,29960,0,0,1000,8870,1100,1000,41930,41930,11970,11970,2017,Private
Texas Wesleyan University,3645,27800,27800,0,0,1800,9166,1850,2684,43300,43300,15500,15500,2017,Private
Trinity University,3647,41344,41344,0,0,1000,10160,500,900,53904,53904,12560,12560,2017,Private
University of Dallas,3651,38716,38716,0,0,1000,8500,1800,1400,51416,51416,12700,12700,2017,Private
University of Mary Hardin-Baylor,3588,27600,27600,0,0,1300,7894,1748,1282,39824,39824,12224,12224,2017,Private
University of St. Thomas,3654,32660,32660,0,0,1094,10090,2694,2068,48606,48606,15946,15946,2017,Private
University of the Incarnate Word,3578,29990,29990,0,0,1400,11830,1626,1858,46704,46704,16714,16714,2017,Private
Wayland Baptist University,3663,19430,19430,0,0,1000,11000,2000,2256,35686,35686,16256,16256,2017,Private
Wiley College,3669,12064,12064,0,0,1400,6490,1400,1566,22920,22920,10856,10856,2017,Private
Angelo State University,3541,8489,20939,0,0,1200,9130,1800,1367,21986,34436,13497,13497,2018,Public
Lamar University,3581,10212,22660,0,0,1012,7632,2424,1812,23092,35540,12880,12880,2018,Public
Midwestern State University,3592,9233,11183,0,0,1050,8877,2066,1909,23135,25085,13902,13902,2018,Public
Prairie View A&M University,3630,10534,24844,0,0,1302,7355,1532,2555,23278,37588,12744,12744,2018,Public
Sam Houston State University,3606,10182,22632,0,0,1372,9386,2004,1862,24806,37256,14624,14624,2018,Public
Stephen F. Austin State University,3624,10288,22866,0,0,1202,8964,1800,1874,24128,36706,13840,13840,2018,Public
Sul Ross State University,3625,8309,20759,0,0,1366,8802,2490,1552,22519,34969,14210,14210,2018,Public
Sul Ross State University Rio Grande College,20,5524,17974,0,0,1366,7695,1896,1552,18033,30483,12509,12509,2018,Public
Tarleton State University,3631,8692,21142,0,0,1207,10480,1167,1890,23436,35886,14744,14744,2018,Public
Texas A&M International University,9651,8637,22258,0,0,1201,7186,1062,1578,19664,33285,11027,11027,2018,Public
Texas A&M University,3632,10316,30506,0,0,1222,10436,2396,3518,27888,48078,17572,17572,2018,Public
Texas A&M University at Galveston,10298,11606,31796,0,0,1222,13169,2768,2648,31413,51603,19807,19807,2018,Public
Texas A&M University-Central Texas,42295,6549,16508,0,0,1400,9136,1440,1800,20325,30284,13776,13776,2018,Public
Texas A&M University-Commerce,3565,8747,21197,0,0,1400,9032,2111,1905,23195,35645,14448,14448,2018,Public
Texas A&M University-Corpus Christi,11161,9760,22914,0,0,1290,9179,2086,1857,24172,37326,14412,14412,2018,Public
Texas A&M University-Kingsville,3639,8462,22102,0,0,1344,10350,2319,2497,24972,38612,16510,16510,2018,Public
Texas A&M University-San Antonio,42485,8245,21161,0,0,1368,8056,2624,3008,23301,36217,15056,15056,2018,Public
Texas A&M University-Texarkana,29269,8070,23106,0,0,1400,10194,1037,1000,21701,36737,13631,13631,2018,Public
Texas Southern University,3642,9176,21624,0,0,1569,13713,2356,2506,29320,41768,20144,20144,2018,Public
Texas State University,3615,10920,23380,0,0,780,8570,1910,1590,23770,36230,12850,12850,2018,Public
Texas Tech University,3644,11046,23496,0,0,1200,9772,2300,2120,26438,38888,15392,15392,2018,Public
Texas Woman's University,3646,9360,21540,0,0,1050,6993,1269,2439,21111,33291,11751,11751,2018,Public
The University of Texas at Arlington,3656,10250,25134,0,0,1206,10302,2944,1712,26414,41298,16164,16164,2018,Public
The University of Texas at Austin,3658,10398,36744,0,0,700,10804,1490,2902,26294,52640,15896,15896,2018,Public
The University of Texas at Dallas,9741,13034,36876,0,0,1200,11044,2140,2040,29458,53300,16424,16424,2018,Public
The University of Texas at El Paso,3661,8067,22773,0,0,1862,12192,2264,1968,26353,41059,18286,18286,2018,Public
The University of Texas at San Antonio,10115,9978,24339,0,0,1500,10071,3000,1800,26349,40710,16371,16371,2018,Public
The University of Texas at Tyler,11163,8292,21522,0,0,1292,7688,2384,2182,21838,35068,13546,13546,2018,Public
The University of Texas Permian Basin,9930,7844,20294,0,0,1000,11318,1670,1960,23792,36242,15948,15948,2018,Public
The University of Texas-Rio Grande Valley,3599,7813,20263,0,0,1218,8146,2259,2145,21581,34031,13768,13768,2018,Public
University of Houston,3652,10890,26340,0,0,1300,9550,2150,2704,26594,42044,15704,15704,2018,Public
University of Houston-Clear Lake,11711,8500,24731,0,0,1064,8620,2928,3662,24774,41005,16274,16274,2018,Public
University of Houston-Downtown,12826,7772,20222,0,0,1232,8964,2988,4124,25080,37530,17308,17308,2018,Public
University of Houston-Victoria,13231,7970,20420,0,0,1158,8254,2102,2076,21560,34010,13590,13590,2018,Public
University of North Texas,3594,11514,24324,0,0,1000,8446,2412,2158,25530,38340,14016,14016,2018,Public
University of North Texas at Dallas,42421,9140,21590,0,0,1500,7745,2519,2204,23108,35558,13968,13968,2018,Public
West Texas A&M University,3665,8484,22222,0,0,1000,7196,2392,2150,21222,34960,12738,12738,2018,Public
Abilene Christian University,3537,34850,34850,0,0,1250,10350,1450,1822,49722,49722,14872,14872,2018,Private
Amberton University,22594,8070,0,0,0,0,0,0,0,8070,0,0,0,2018,Private
Austin College,3543,39960,39960,0,0,1250,4195,525,850,46780,46780,6820,6820,2018,Private
Baylor University,3545,45792,45792,0,0,1230,11708,1900,1886,62516,62516,16724,16724,2018,Private
Concordia University Texas,3557,31810,31810,0,0,782,7312,1680,1506,43090,43090,11280,11280,2018,Private
Dallas Baptist University,3560,28996,28996,0,0,1320,11151,3024,2061,46552,46552,17556,17556,2018,Private
East Texas Baptist University,3564,26370,26370,0,0,880,5046,914,1544,34754,34754,8384,8384,2018,Private
Hardin-Simmons University,3571,28990,28990,0,0,800,8080,1200,1976,41046,41046,12056,12056,2018,Private
Houston Baptist University,3576,32530,32530,0,0,1000,9650,3080,2720,48980,48980,16450,16450,2018,Private
Howard Payne University,3575,28090,28090,0,0,1200,5800,1222,1800,38112,38112,10022,10022,2018,Private
Huston-Tillotson University,3577,14426,14426,0,0,1000,7650,1000,500,24576,24576,10150,10150,2018,Private
Jarvis Christian College,3637,11720,11720,0,0,1000,6400,1800,1200,22120,22120,10400,10400,2018,Private
Letourneau University,3584,30860,30860,0,0,1580,10540,1382,1816,46178,46178,15318,15318,2018,Private
Lubbock Christian University,3586,22440,22440,0,0,1200,7702,2332,2610,36284,36284,13844,13844,2018,Private
McMurry University,3591,27244,27244,0,0,0,5452,2028,3028,37752,37752,10508,10508,2018,Private
Our Lady of the Lake University of San Antonio,3598,28740,28740,0,0,1200,9602,1450,1850,42842,42842,14102,14102,2018,Private
Rice University,3604,47345,47345,0,0,1200,14000,700,2600,65845,65845,18500,18500,2018,Private
Schreiner University,3610,27960,27960,0,0,0,12068,1000,1000,42028,42028,14068,14068,2018,Private
Southern Methodist University,3613,54492,54492,0,0,800,8700,1000,1676,66668,66668,12176,12176,2018,Private
Southwestern Adventist University,3619,21564,21564,0,0,1200,7474,1198,1405,32841,32841,11277,11277,2018,Private
Southwestern Assemblies of God University,3616,19582,19582,0,0,1310,13830,2042,2768,39532,39532,19950,19950,2018,Private
Southwestern Christian College,3618,9040,9040,0,0,1088,4481,800,600,16009,16009,6969,6969,2018,Private
Southwestern University,3620,42000,42000,0,0,1300,11640,950,1000,56890,56890,14890,14890,2018,Private
St. Edward's University,3621,45178,45178,0,0,1200,12560,1082,1650,61670,61670,16492,16492,2018,Private
St. Mary's University,3623,30650,30650,0,0,1300,4000,1000,2000,38950,38950,8300,8300,2018,Private
Texas Christian University,3636,46950,46950,0,0,950,12804,1300,3680,65684,65684,18734,18734,2018,Private
Texas College,3638,10008,10008,0,0,1200,7600,3000,2300,24108,24108,14100,14100,2018,Private
Texas Lutheran University,3641,29960,29960,0,0,1000,8870,1400,1000,42230,42230,12270,12270,2018,Private
Texas Wesleyan University,3645,30300,30300,0,0,2000,9600,1850,1994,45744,45744,15444,15444,2018,Private
Trinity University,3647,42976,42976,0,0,1000,10413,500,900,55789,55789,12813,12813,2018,Private
University of Dallas,3651,40652,40652,0,0,1000,8500,1800,1400,53352,53352,12700,12700,2018,Private
University of Mary Hardin-Baylor,3588,28650,28650,0,0,1300,8446,1748,1282,41426,41426,12776,12776,2018,Private
University of St. Thomas,3654,33580,33580,0,0,1094,10090,2694,2068,49526,49526,15946,15946,2018,Private
University of the Incarnate Word,3578,31484,31484,0,0,1400,12186,1676,1912,48658,48658,17174,17174,2018,Private
Wayland Baptist University,3663,20070,20070,0,0,1000,11000,2000,2256,36326,36326,16256,16256,2018,Private
Wiley College,3669,12552,12552,0,0,1425,6607,1425,1594,23603,23603,11051,11051,2018,Private
Angelo State University,3541,8720,21380,0,0,1200,9130,1800,1480,22330,34990,13610,13610,2019,Public
Lamar University,3581,10340,23004,0,0,1012,7632,2424,1812,23220,35884,12880,12880,2019,Public
Midwestern State University,3592,9601,11551,0,0,1050,9564,1800,1950,23965,25915,14364,14364,2019,Public
Prairie View A&M University,3630,10785,25653,0,0,1340,7571,1577,2710,23983,38851,13198,13198,2019,Public
Sam Houston State University,3606,10482,22932,0,0,1372,9670,2004,1862,25390,37840,14908,14908,2019,Public
Stephen F. Austin State University,3624,10946,23398,0,0,1202,9012,1800,1874,24834,37286,13888,13888,2019,Public
Sul Ross State University,3625,8554,21214,0,0,1270,9558,3620,1552,24554,37214,16000,16000,2019,Public
Sul Ross State University Rio Grande College,20,5686,18346,0,0,1270,8010,2272,1552,18790,31450,13104,13104,2019,Public
Tarleton State University,3631,8956,21618,0,0,1276,10712,1201,1946,24091,36753,15135,15135,2019,Public
Texas A&M International University,9651,8844,23002,0,0,1180,7217,1316,1584,20141,34299,11297,11297,2019,Public
Texas A&M University,3632,10562,37591,0,0,1222,10400,2498,3746,28428,55457,17866,17866,2019,Public
Texas A&M University at Galveston,10298,11885,38913,0,0,1222,12500,3168,3414,32189,59217,20304,20304,2019,Public
Texas A&M University-Central Texas,42295,6702,16830,0,0,1400,9136,1440,1800,20478,30606,13776,13776,2019,Public
Texas A&M University-Commerce,3565,8958,21618,0,0,1400,9032,2111,1905,23406,36066,14448,14448,2019,Public
Texas A&M University-Corpus Christi,11161,10020,23338,0,0,1350,9948,2647,1879,25844,39162,15824,15824,2019,Public
Texas A&M University-Kingsville,3639,9136,24687,0,0,1344,10569,2366,2547,25962,41513,16826,16826,2019,Public
Texas A&M University-San Antonio,42485,8245,21161,0,0,1368,8056,2624,3008,23301,36217,15056,15056,2019,Public
Texas A&M University-Texarkana,29269,8264,23870,0,0,1400,10461,1037,1000,22162,37768,13898,13898,2019,Public
Texas Southern University,3642,9174,21834,0,0,1620,13713,2356,2506,29369,42029,20195,20195,2019,Public
Texas State University,3615,11240,23900,0,0,800,8820,1960,1630,24450,37110,13210,13210,2019,Public
Texas Tech University,3644,11320,23770,0,0,1200,9772,2300,2120,26712,39162,15392,15392,2019,Public
Texas Woman's University,3646,9480,21930,0,0,1050,7551,1269,2439,21789,34239,12309,12309,2019,Public
The University of Texas at Arlington,3656,11040,27920,0,0,1206,10290,3000,1744,27280,44160,16240,16240,2019,Public
The University of Texas at Austin,3658,10314,36716,0,0,700,11812,1490,2902,27218,53620,16904,16904,2019,Public
The University of Texas at Dallas,9741,13442,38000,0,0,1200,11044,2226,2250,30162,54720,16720,16720,2019,Public
The University of Texas at El Paso,3661,8340,23493,0,0,1883,12192,2264,1968,26647,41800,18307,18307,2019,Public
The University of Texas at San Antonio,10115,9724,24724,0,0,1000,10071,3020,1836,25651,40651,15927,15927,2019,Public
The University of Texas at Tyler,11163,8742,22752,0,0,1292,7918,2438,2232,22622,36632,13880,13880,2019,Public
The University of Texas Permian Basin,9930,8464,20834,0,0,1634,13520,1670,1960,27248,39618,18784,18784,2019,Public
The University of Texas-Rio Grande Valley,3599,8132,20792,0,0,1237,8198,2237,2164,21968,34628,13836,13836,2019,Public
University of Houston,3652,11276,26936,0,0,1338,9231,2280,2784,26909,42569,15633,15633,2019,Public
University of Houston-Clear Lake,11711,7961,24545,0,0,1064,10218,3341,5053,27637,44221,19676,19676,2019,Public
University of Houston-Downtown,12826,8386,21046,0,0,1268,9228,3076,4124,26082,38742,17696,17696,2019,Public
University of Houston-Victoria,13231,8328,20988,0,0,1158,8254,2102,2076,21918,34578,13590,13590,2019,Public
University of North Texas,3594,11712,24372,0,0,1000,8684,2464,2262,26122,38782,14410,14410,2019,Public
University of North Texas at Dallas,42421,9140,21810,0,0,1500,7822,2544,2226,23232,35902,14092,14092,2019,Public
West Texas A&M University,3665,8688,22034,0,0,1000,7196,2392,2150,21426,34772,12738,12738,2019,Public
Abilene Christian University,3537,36300,36300,0,0,1250,11068,1450,1822,51890,51890,15590,15590,2019,Private
Amberton University,22594,8070,0,0,0,1600,0,0,0,9670,1600,1600,1600,2019,Private
Austin College,3543,41155,41155,0,0,1250,4015,525,850,47795,47795,6640,6640,2019,Private
Baylor University,3545,47564,47564,0,0,1264,12020,1970,1930,64748,64748,17184,17184,2019,Private
Concordia University Texas,3557,32760,32760,0,0,786,7509,1725,1547,44327,44327,11567,11567,2019,Private
Dallas Baptist University,3560,31692,31692,0,0,1350,11430,3249,2124,49845,49845,18153,18153,2019,Private
East Texas Baptist University,3564,27210,27210,0,0,880,5850,1200,1350,36490,36490,9280,9280,2019,Private
Hardin-Simmons University,3571,30140,30140,0,0,800,9230,1200,1976,43346,43346,13206,13206,2019,Private
Houston Baptist University,3576,33450,33450,0,0,1000,9800,3168,2802,50220,50220,16770,16770,2019,Private
Howard Payne University,3575,29198,29198,0,0,1200,6000,1222,1900,39520,39520,10322,10322,2019,Private
Huston-Tillotson University,3577,14426,14426,0,0,1000,7650,1000,500,24576,24576,10150,10150,2019,Private
Jarvis Christian College,3637,11720,11720,0,0,1000,6400,1800,1200,22120,22120,10400,10400,2019,Private
Letourneau University,3584,31920,31920,0,0,1612,10750,1410,1852,47544,47544,15624,15624,2019,Private
Lubbock Christian University,3586,23330,23330,0,0,1300,7940,2400,2690,37660,37660,14330,14330,2019,Private
McMurry University,3591,27924,27924,0,0,1200,6372,2028,3028,40552,40552,12628,12628,2019,Private
Our Lady of the Lake University of San Antonio,3598,29218,29218,0,0,1200,9730,1450,1850,43448,43448,14230,14230,2019,Private
Rice University,3604,49112,49112,0,0,1200,14140,700,2650,67802,67802,18690,18690,2019,Private
Schreiner University,3610,30895,30595,0,0,0,12068,1000,1000,44963,44663,14068,14068,2019,Private
Southern Methodist University,3613,56560,56560,0,0,800,8700,1000,1676,68736,68736,12176,12176,2019,Private
Southwestern Adventist University,3619,22188,22188,0,0,1200,7668,1176,1424,33656,33656,11468,11468,2019,Private
Southwestern Assemblies of God University,3616,19834,19834,0,0,1324,13968,2062,2794,39982,39982,20148,20148,2019,Private
Southwestern Christian College,3618,9040,9040,0,0,1168,4481,800,600,16089,16089,7049,7049,2019,Private
Southwestern University,3620,43560,43560,0,0,1300,11970,980,1030,58840,58840,15280,15280,2019,Private
St. Edward's University,3621,47190,47190,0,0,1200,12774,1076,1700,63940,63940,16750,16750,2019,Private
St. Mary's University,3623,32140,32140,0,0,1300,4000,1000,2000,40440,40440,8300,8300,2019,Private
Texas Christian University,3636,49250,49250,0,0,900,13200,1300,3764,68414,68414,19164,19164,2019,Private
Texas College,3638,10008,10008,0,0,1200,7600,3000,2300,24108,24108,14100,14100,2019,Private
Texas Lutheran University,3641,30860,30860,0,0,1000,10440,1400,1130,44830,44830,13970,13970,2019,Private
Texas Wesleyan University,3645,31816,31816,0,0,2032,9654,1880,2845,48227,48227,16411,16411,2019,Private
Trinity University,3647,44680,44680,0,0,1000,10674,500,900,57754,57754,13074,13074,2019,Private
University of Dallas,3651,42680,42680,0,0,1040,9000,1620,1300,55640,55640,12960,12960,2019,Private
University of Mary Hardin-Baylor,3588,29700,29700,0,0,1300,8782,1748,1282,42812,42812,13112,13112,2019,Private
University of St. Thomas,3654,31460,31460,0,0,1094,10090,2694,2068,47406,47406,15946,15946,2019,Private
University of the Incarnate Word,3578,32576,32576,0,0,1400,12284,1690,1960,49910,49910,17334,17334,2019,Private
Wayland Baptist University,3663,20738,20738,0,0,1000,11323,2000,2400,37461,37461,16723,16723,2019,Private
Wiley College,3669,13152,13152,0,0,0,7484,1020,1060,22716,22716,9564,9564,2019,Private
Angelo State University,3541,9010,21280,0,0,1200,9630,1800,1480,23120,35390,14110,14110,2020,Public
Lamar University,3581,10463,22734,0,0,1200,8888,3168,1812,25531,37802,15068,15068,2020,Public
Midwestern State University,3592,9796,11746,0,0,1050,9504,1800,1986,24136,26086,14340,14340,2020,Public
Prairie View A&M University,3630,11099,26398,0,0,1362,7695,1603,2637,24396,39695,13297,13297,2020,Public
Sam Houston State University,3606,10756,23026,0,0,1380,9670,2004,1862,25672,37942,14916,14916,2020,Public
Stephen F. Austin State University,3624,10600,22870,0,0,1202,9642,1800,1874,25118,37388,14518,14518,2020,Public
Sul Ross State University,3625,8776,21046,0,0,1242,10098,3594,1592,25302,37572,16526,16526,2020,Public
Sul Ross State University Rio Grande College,20,5833,18103,0,0,1242,8712,4494,1592,21873,34143,16040,16040,2020,Public
Tarleton State University,3631,9529,21799,0,0,1296,12240,1220,1977,26262,38532,16733,16733,2020,Public
Texas A&M International University,9651,9254,23390,0,0,1270,7265,1238,2736,21763,35899,12509,12509,2020,Public
Texas A&M University,3632,11404,39136,0,0,1222,11400,2498,3500,30024,57756,18620,18620,2020,Public
Texas A&M University at Galveston,10298,12192,39533,0,0,1222,12500,3168,3500,32582,59923,20390,20390,2020,Public
Texas A&M University-Central Texas,42295,6483,16299,0,0,1400,9226,1490,1800,20399,30215,13916,13916,2020,Public
Texas A&M University-Commerce,3565,9820,22090,0,0,1176,9550,2214,1874,24634,36904,14814,14814,2020,Public
Texas A&M University-Corpus Christi,11161,9825,23937,0,0,1370,10832,1740,1906,25673,39785,15848,15848,2020,Public
Texas A&M University-Kingsville,3639,9694,25266,0,0,1244,9452,2324,1716,24430,40002,14736,14736,2020,Public
Texas A&M University-San Antonio,42485,8442,22168,0,0,1200,8418,3216,3428,24704,38430,16262,16262,2020,Public
Texas A&M University-Texarkana,29269,8449,24523,0,0,1400,10800,1046,2334,24029,40103,15580,15580,2020,Public
Texas Southern University,3642,9570,21834,0,0,1647,13938,2395,2550,30100,42364,20530,20530,2020,Public
Texas State University,3615,11540,23820,0,0,760,10210,1950,2160,26620,38900,15080,15080,2020,Public
Texas Tech University,3644,11600,23870,0,0,1200,9956,2400,2000,27156,39426,15556,15556,2020,Public
Texas Woman's University,3646,9630,22290,0,0,1050,7776,1287,2475,22218,34878,12588,12588,2020,Public
The University of Texas at Arlington,3656,11620,28500,0,0,1206,10370,3024,1776,27996,44876,16376,16376,2020,Public
The University of Texas at Austin,3658,10582,37670,0,0,714,12286,1520,2960,28062,55150,17480,17480,2020,Public
The University of Texas at Dallas,9741,14072,39050,0,0,1200,11474,2672,2250,31668,56646,17596,17596,2020,Public
The University of Texas at El Paso,3661,8652,23718,0,0,1883,12192,2264,1968,26959,42025,18307,18307,2020,Public
The University of Texas at San Antonio,10115,10600,25606,0,0,1000,10071,3020,1836,26527,41533,15927,15927,2020,Public
The University of Texas at Tyler,11163,9146,23736,0,0,1292,8102,2470,2262,23272,37862,14126,14126,2020,Public
The University of Texas Permian Basin,9930,8806,21076,0,0,1684,10672,1720,2020,24902,37172,16096,16096,2020,Public
The University of Texas-Rio Grande Valley,3599,8917,21187,0,0,1240,8126,2324,2196,22803,35073,13886,13886,2020,Public
University of Houston,3652,11569,26839,0,0,1300,9419,2261,2830,27379,42649,15810,15810,2020,Public
University of Houston-Clear Lake,11711,9174,25772,0,0,1316,10820,3537,5279,30126,46724,20952,20952,2020,Public
University of Houston-Downtown,12826,8604,20874,0,0,1288,9380,3128,4192,26592,38862,17988,17988,2020,Public
University of Houston-Victoria,13231,8544,20814,0,0,1000,9900,2102,2076,23622,35892,15078,15078,2020,Public
University of North Texas,3594,11994,24654,0,0,1000,9456,2464,2348,27262,39922,15268,15268,2020,Public
University of North Texas at Dallas,42421,9140,21810,0,0,1500,7900,2569,2248,23357,36027,14217,14217,2020,Public
West Texas A&M University,3665,9040,23342,0,0,1000,8198,2392,2150,22780,37082,13740,13740,2020,Public
Abilene Christian University,3537,37870,37870,0,0,1250,11348,1450,1822,53740,53740,15870,15870,2020,Private
Amberton University,22594,8670,0,0,0,1600,0,0,0,10270,1600,1600,1600,2020,Private
Austin College,3543,42590,42590,0,0,1250,6250,525,850,51465,51465,8875,8875,2020,Private
Baylor University,3545,49446,49446,0,0,1284,12316,1928,1974,66948,66948,17502,17502,2020,Private
Concordia University Texas,3557,33800,33800,0,0,786,7592,1744,1564,45486,45486,11686,11686,2020,Private
Dallas Baptist University,3560,32040,32040,0,0,1320,11601,3060,2061,50082,50082,18042,18042,2020,Private
East Texas Baptist University,3564,27640,27640,0,0,880,5850,1200,1450,37020,37020,9380,9380,2020,Private
Hardin-Simmons University,3571,31364,31364,0,0,800,9740,1200,1976,45080,45080,13716,13716,2020,Private
Houston Baptist University,3576,34500,34500,0,0,1000,9800,3168,2802,51270,51270,16770,16770,2020,Private
Howard Payne University,3575,29378,29368,0,0,1200,8000,1222,1900,41700,41690,12322,12322,2020,Private
Huston-Tillotson University,3577,15250,15250,0,0,1000,10710,1000,706,28666,28666,13416,13416,2020,Private
Jarvis Christian College,3637,11720,11720,0,0,1000,6400,1800,1200,22120,22120,10400,10400,2020,Private
Letourneau University,3584,33140,33140,0,0,1612,10750,1410,1852,48764,48764,15624,15624,2020,Private
Lubbock Christian University,3586,24260,24260,0,0,1300,8070,2440,2734,38804,38804,14544,14544,2020,Private
McMurry University,3591,28620,28620,0,0,1200,6588,2028,3028,41464,41464,12844,12844,2020,Private
Our Lady of the Lake University of San Antonio,3598,29926,29926,0,0,0,7990,1450,1850,41216,41216,11290,11290,2020,Private
Rice University,3604,51107,51107,0,0,1250,14500,700,2700,70257,70257,19150,19150,2020,Private
Schreiner University,3610,31938,31938,0,0,0,12068,600,1683,46289,46289,14351,14351,2020,Private
Southern Methodist University,3613,58540,58540,0,0,800,8700,1000,1676,70716,70716,12176,12176,2020,Private
Southwestern Adventist University,3619,22420,22836,0,0,1200,7864,1194,1448,34126,34542,11706,11706,2020,Private
Southwestern Assemblies of God University,3616,19834,19834,0,0,1324,13968,2062,2794,39982,39982,20148,20148,2020,Private
Southwestern Christian College,3618,9040,9040,0,0,1168,4181,800,600,15789,15789,6749,6749,2020,Private
Southwestern University,3620,45120,45120,0,0,1300,12350,1000,1050,60820,60820,15700,15700,2020,Private
St. Edward's University,3621,49076,49076,0,0,1200,13328,1070,1700,66374,66374,17298,17298,2020,Private
St. Mary's University,3623,33720,33720,0,0,1300,4000,1000,2000,42020,42020,8300,8300,2020,Private
Texas Christian University,3636,51660,51660,0,0,900,14040,1400,3828,71828,71828,20168,20168,2020,Private
Texas College,3638,10008,10008,0,0,1200,8000,3000,2200,24408,24408,14400,14400,2020,Private
Texas Lutheran University,3641,31850,31850,0,0,1000,10690,1400,1330,46270,46270,14420,14420,2020,Private
Texas Wesleyan University,3645,33408,33408,0,0,1200,10728,2000,1500,48836,48836,15428,15428,2020,Private
Trinity University,3647,46456,46456,0,0,1000,11016,500,900,59872,59872,13416,13416,2020,Private
University of Dallas,3651,44810,44810,0,0,1040,9000,1620,1300,57770,57770,12960,12960,2020,Private
University of Mary Hardin-Baylor,3588,30750,30750,0,0,1300,9134,1748,1282,44214,44214,13464,13464,2020,Private
University of St. Thomas,3654,31560,31560,0,0,1094,10090,2694,2068,47506,47506,15946,15946,2020,Private
University of the Incarnate Word,3578,32286,32286,0,0,1400,12518,1720,1990,49914,49914,17628,17628,2020,Private
Wayland Baptist University,3663,21304,21304,0,0,1000,8640,1280,2000,34224,34224,12920,12920,2020,Private
Wiley College,3669,12500,12500,0,0,0,5000,1020,1060,19580,19580,7080,7080,2020,Private
